"","Hero1","Hero2","wins","losses","num_of_picks","win_percentage"
"1",1,10,21,44,65,0.323076923076923
"2",1,100,378,410,788,0.479695431472081
"3",1,101,103,146,249,0.413654618473896
"4",1,102,140,111,251,0.557768924302789
"5",1,103,27,32,59,0.457627118644068
"6",1,104,256,295,551,0.464609800362976
"7",1,105,48,65,113,0.424778761061947
"8",1,106,160,179,339,0.471976401179941
"9",1,107,97,103,200,0.485
"10",1,109,12,26,38,0.315789473684211
"11",1,11,598,658,1256,0.476114649681529
"12",1,110,121,123,244,0.495901639344262
"13",1,111,37,42,79,0.468354430379747
"14",1,112,339,323,662,0.512084592145015
"15",1,12,16,29,45,0.355555555555556
"16",1,13,59,83,142,0.415492957746479
"17",1,14,358,385,743,0.481830417227456
"18",1,15,45,53,98,0.459183673469388
"19",1,16,116,156,272,0.426470588235294
"20",1,17,67,120,187,0.358288770053476
"21",1,18,40,57,97,0.412371134020619
"22",1,19,93,152,245,0.379591836734694
"23",1,2,139,196,335,0.414925373134328
"24",1,20,153,139,292,0.523972602739726
"25",1,21,708,865,1573,0.450095359186268
"26",1,22,186,159,345,0.539130434782609
"27",1,23,78,92,170,0.458823529411765
"28",1,25,274,382,656,0.417682926829268
"29",1,26,279,373,652,0.427914110429448
"30",1,27,133,130,263,0.505703422053232
"31",1,28,359,345,704,0.509943181818182
"32",1,29,79,114,193,0.409326424870466
"33",1,3,84,116,200,0.42
"34",1,30,261,319,580,0.45
"35",1,31,189,190,379,0.49868073878628
"36",1,32,122,112,234,0.521367521367521
"37",1,33,94,110,204,0.46078431372549
"38",1,34,80,126,206,0.388349514563107
"39",1,35,64,128,192,0.333333333333333
"40",1,36,224,216,440,0.509090909090909
"41",1,37,67,71,138,0.485507246376812
"42",1,38,43,38,81,0.530864197530864
"43",1,39,358,485,843,0.424673784104389
"44",1,4,53,92,145,0.36551724137931
"45",1,40,122,98,220,0.554545454545455
"46",1,41,23,49,72,0.319444444444444
"47",1,42,103,111,214,0.481308411214953
"48",1,43,51,75,126,0.404761904761905
"49",1,44,49,78,127,0.385826771653543
"50",1,45,53,75,128,0.4140625
"51",1,46,189,224,413,0.457627118644068
"52",1,47,102,119,221,0.461538461538462
"53",1,48,20,41,61,0.327868852459016
"54",1,49,49,65,114,0.429824561403509
"55",1,5,273,304,577,0.47313691507799
"56",1,50,332,368,700,0.474285714285714
"57",1,51,154,184,338,0.455621301775148
"58",1,52,35,48,83,0.421686746987952
"59",1,53,83,154,237,0.350210970464135
"60",1,54,42,58,100,0.42
"61",1,55,149,174,323,0.461300309597523
"62",1,56,49,62,111,0.441441441441441
"63",1,57,186,179,365,0.50958904109589
"64",1,58,26,57,83,0.313253012048193
"65",1,59,73,122,195,0.374358974358974
"66",1,6,42,47,89,0.471910112359551
"67",1,60,108,109,217,0.497695852534562
"68",1,61,48,68,116,0.413793103448276
"69",1,62,215,265,480,0.447916666666667
"70",1,63,55,63,118,0.466101694915254
"71",1,64,101,96,197,0.512690355329949
"72",1,65,38,51,89,0.426966292134831
"73",1,66,17,30,47,0.361702127659574
"74",1,67,32,36,68,0.470588235294118
"75",1,68,234,257,491,0.476578411405295
"76",1,69,282,294,576,0.489583333333333
"77",1,7,468,484,952,0.491596638655462
"78",1,70,83,85,168,0.494047619047619
"79",1,71,255,238,493,0.517241379310345
"80",1,72,49,77,126,0.388888888888889
"81",1,73,230,270,500,0.46
"82",1,74,465,499,964,0.482365145228216
"83",1,75,268,291,559,0.479427549194991
"84",1,76,35,56,91,0.384615384615385
"85",1,77,26,21,47,0.553191489361702
"86",1,78,29,35,64,0.453125
"87",1,79,39,64,103,0.378640776699029
"88",1,8,79,100,179,0.441340782122905
"89",1,80,28,42,70,0.4
"90",1,81,26,47,73,0.356164383561644
"91",1,82,44,45,89,0.49438202247191
"92",1,83,61,67,128,0.4765625
"93",1,84,173,188,361,0.479224376731302
"94",1,85,233,185,418,0.557416267942584
"95",1,86,285,406,691,0.412445730824891
"96",1,87,202,205,407,0.496314496314496
"97",1,88,113,115,228,0.495614035087719
"98",1,89,20,27,47,0.425531914893617
"99",1,9,252,272,524,0.480916030534351
"100",1,90,68,95,163,0.417177914110429
"101",1,91,26,54,80,0.325
"102",1,92,28,42,70,0.4
"103",1,93,79,88,167,0.473053892215569
"104",1,94,21,29,50,0.42
"105",1,95,18,32,50,0.36
"106",1,96,71,65,136,0.522058823529412
"107",1,97,140,189,329,0.425531914893617
"108",1,98,85,145,230,0.369565217391304
"109",1,99,112,155,267,0.419475655430712
"110",10,100,55,54,109,0.504587155963303
"111",10,101,10,22,32,0.3125
"112",10,102,17,27,44,0.386363636363636
"113",10,103,4,7,11,0.363636363636364
"114",10,104,35,61,96,0.364583333333333
"115",10,106,28,34,62,0.451612903225806
"116",10,107,12,21,33,0.363636363636364
"117",10,11,73,102,175,0.417142857142857
"118",10,110,12,12,24,0.5
"119",10,111,5,8,13,0.384615384615385
"120",10,112,44,40,84,0.523809523809524
"121",10,12,9,11,20,0.45
"122",10,13,4,8,12,0.333333333333333
"123",10,14,48,70,118,0.406779661016949
"124",10,15,7,12,19,0.368421052631579
"125",10,16,22,24,46,0.478260869565217
"126",10,17,10,16,26,0.384615384615385
"127",10,18,12,13,25,0.48
"128",10,19,22,34,56,0.392857142857143
"129",10,20,31,28,59,0.525423728813559
"130",10,21,94,116,210,0.447619047619048
"131",10,22,19,29,48,0.395833333333333
"132",10,25,31,66,97,0.319587628865979
"133",10,26,35,52,87,0.402298850574713
"134",10,27,20,25,45,0.444444444444444
"135",10,28,49,64,113,0.433628318584071
"136",10,29,10,12,22,0.454545454545455
"137",10,30,45,36,81,0.555555555555556
"138",10,31,22,34,56,0.392857142857143
"139",10,32,18,17,35,0.514285714285714
"140",10,33,15,15,30,0.5
"141",10,34,11,18,29,0.379310344827586
"142",10,35,11,20,31,0.354838709677419
"143",10,36,32,34,66,0.484848484848485
"144",10,37,10,14,24,0.416666666666667
"145",10,38,5,8,13,0.384615384615385
"146",10,39,33,65,98,0.336734693877551
"147",10,40,12,15,27,0.444444444444444
"148",10,41,10,13,23,0.434782608695652
"149",10,42,29,25,54,0.537037037037037
"150",10,43,4,10,14,0.285714285714286
"151",10,44,19,37,56,0.339285714285714
"152",10,45,6,8,14,0.428571428571429
"153",10,46,31,32,63,0.492063492063492
"154",10,47,15,19,34,0.441176470588235
"155",10,48,13,13,26,0.5
"156",10,49,10,12,22,0.454545454545455
"157",10,50,37,65,102,0.362745098039216
"158",10,51,26,37,63,0.412698412698413
"159",10,52,5,9,14,0.357142857142857
"160",10,53,12,21,33,0.363636363636364
"161",10,54,8,6,14,0.571428571428571
"162",10,55,19,27,46,0.41304347826087
"163",10,56,9,12,21,0.428571428571429
"164",10,57,28,25,53,0.528301886792453
"165",10,59,16,19,35,0.457142857142857
"166",10,60,17,18,35,0.485714285714286
"167",10,61,4,12,16,0.25
"168",10,62,33,43,76,0.434210526315789
"169",10,63,6,17,23,0.260869565217391
"170",10,64,11,15,26,0.423076923076923
"171",10,65,4,8,12,0.333333333333333
"172",10,67,23,23,46,0.5
"173",10,68,25,43,68,0.367647058823529
"174",10,69,39,45,84,0.464285714285714
"175",10,70,21,22,43,0.488372093023256
"176",10,71,35,46,81,0.432098765432099
"177",10,72,24,34,58,0.413793103448276
"178",10,73,58,75,133,0.43609022556391
"179",10,74,58,51,109,0.532110091743119
"180",10,75,42,46,88,0.477272727272727
"181",10,76,6,12,18,0.333333333333333
"182",10,77,4,3,7,0.571428571428571
"183",10,78,6,11,17,0.352941176470588
"184",10,79,3,10,13,0.230769230769231
"185",10,80,6,6,12,0.5
"186",10,81,8,7,15,0.533333333333333
"187",10,82,6,14,20,0.3
"188",10,83,10,10,20,0.5
"189",10,84,26,24,50,0.52
"190",10,85,32,39,71,0.450704225352113
"191",10,86,33,59,92,0.358695652173913
"192",10,87,21,24,45,0.466666666666667
"193",10,88,17,19,36,0.472222222222222
"194",10,89,2,6,8,0.25
"195",10,90,7,11,18,0.388888888888889
"196",10,91,7,14,21,0.333333333333333
"197",10,92,6,5,11,0.545454545454545
"198",10,93,24,39,63,0.380952380952381
"199",10,94,7,8,15,0.466666666666667
"200",10,95,4,13,17,0.235294117647059
"201",10,96,8,11,19,0.421052631578947
"202",10,97,13,18,31,0.419354838709677
"203",10,98,15,15,30,0.5
"204",10,99,21,26,47,0.446808510638298
"205",100,101,112,118,230,0.48695652173913
"206",100,102,128,67,195,0.656410256410256
"207",100,103,18,21,39,0.461538461538462
"208",100,104,264,273,537,0.491620111731844
"209",100,105,38,55,93,0.408602150537634
"210",100,106,353,350,703,0.502133712660028
"211",100,107,83,79,162,0.512345679012346
"212",100,109,67,50,117,0.572649572649573
"213",100,110,98,86,184,0.532608695652174
"214",100,111,30,33,63,0.476190476190476
"215",100,112,295,284,579,0.509499136442142
"216",101,102,22,26,48,0.458333333333333
"217",101,103,8,4,12,0.666666666666667
"218",101,104,103,161,264,0.390151515151515
"219",101,105,10,12,22,0.454545454545455
"220",101,106,64,124,188,0.340425531914894
"221",101,107,34,37,71,0.47887323943662
"222",101,109,13,18,31,0.419354838709677
"223",101,110,30,28,58,0.517241379310345
"224",101,111,5,12,17,0.294117647058824
"225",101,112,42,47,89,0.471910112359551
"226",102,103,7,3,10,0.7
"227",102,104,102,86,188,0.542553191489362
"228",102,105,18,7,25,0.72
"229",102,106,92,85,177,0.519774011299435
"230",102,107,19,30,49,0.387755102040816
"231",102,109,25,19,44,0.568181818181818
"232",102,110,41,29,70,0.585714285714286
"233",102,111,11,11,22,0.5
"234",102,112,82,59,141,0.581560283687943
"235",103,104,32,28,60,0.533333333333333
"236",103,106,32,31,63,0.507936507936508
"237",103,107,5,3,8,0.625
"238",103,109,7,4,11,0.636363636363636
"239",103,110,3,8,11,0.272727272727273
"240",103,112,29,11,40,0.725
"241",104,105,38,51,89,0.426966292134831
"242",104,106,191,230,421,0.453681710213777
"243",104,107,68,77,145,0.468965517241379
"244",104,109,41,41,82,0.5
"245",104,110,111,89,200,0.555
"246",104,111,39,38,77,0.506493506493506
"247",104,112,232,226,458,0.506550218340611
"248",105,106,31,33,64,0.484375
"249",105,107,6,6,12,0.5
"250",105,109,6,4,10,0.6
"251",105,110,12,11,23,0.521739130434783
"252",105,111,3,6,9,0.333333333333333
"253",105,112,15,31,46,0.326086956521739
"254",106,107,92,104,196,0.469387755102041
"255",106,109,41,28,69,0.594202898550725
"256",106,110,88,96,184,0.478260869565217
"257",106,111,35,35,70,0.5
"258",106,112,237,264,501,0.473053892215569
"259",107,109,21,15,36,0.583333333333333
"260",107,110,19,23,42,0.452380952380952
"261",107,111,16,8,24,0.666666666666667
"262",107,112,92,78,170,0.541176470588235
"263",109,110,10,15,25,0.4
"264",109,111,10,10,20,0.5
"265",109,112,42,32,74,0.567567567567568
"266",11,100,807,751,1558,0.517971758664955
"267",11,101,186,202,388,0.479381443298969
"268",11,102,271,168,439,0.617312072892939
"269",11,103,61,49,110,0.554545454545455
"270",11,104,551,489,1040,0.529807692307692
"271",11,105,59,82,141,0.418439716312057
"272",11,106,281,309,590,0.476271186440678
"273",11,107,254,181,435,0.583908045977012
"274",11,109,93,95,188,0.49468085106383
"275",11,110,256,187,443,0.577878103837472
"276",11,111,67,67,134,0.5
"277",11,112,667,581,1248,0.534455128205128
"278",11,12,204,248,452,0.451327433628319
"279",11,13,49,74,123,0.398373983739837
"280",11,14,468,450,918,0.509803921568627
"281",11,15,87,82,169,0.514792899408284
"282",11,16,237,218,455,0.520879120879121
"283",11,17,39,54,93,0.419354838709677
"284",11,18,226,207,433,0.521939953810624
"285",11,19,223,257,480,0.464583333333333
"286",11,20,354,309,663,0.53393665158371
"287",11,21,784,905,1689,0.464179988158674
"288",11,22,168,116,284,0.591549295774648
"289",11,23,114,142,256,0.4453125
"290",11,25,289,403,692,0.417630057803468
"291",11,26,527,528,1055,0.499526066350711
"292",11,27,262,212,474,0.552742616033755
"293",11,28,1023,776,1799,0.568649249583102
"294",11,29,188,168,356,0.528089887640449
"295",11,30,539,438,977,0.551688843398158
"296",11,31,384,301,685,0.560583941605839
"297",11,32,276,226,502,0.549800796812749
"298",11,33,191,195,386,0.494818652849741
"299",11,34,40,42,82,0.48780487804878
"300",11,35,132,161,293,0.450511945392491
"301",11,36,410,284,694,0.590778097982709
"302",11,37,127,91,218,0.582568807339449
"303",11,38,90,65,155,0.580645161290323
"304",11,39,232,302,534,0.434456928838951
"305",11,40,191,170,361,0.529085872576177
"306",11,41,167,181,348,0.479885057471264
"307",11,42,739,428,1167,0.63324764353042
"308",11,43,60,51,111,0.540540540540541
"309",11,44,420,419,839,0.500595947556615
"310",11,45,93,100,193,0.481865284974093
"311",11,46,53,60,113,0.469026548672566
"312",11,47,149,107,256,0.58203125
"313",11,48,155,122,277,0.55956678700361
"314",11,49,80,66,146,0.547945205479452
"315",11,50,715,579,1294,0.552550231839258
"316",11,51,357,285,642,0.55607476635514
"317",11,52,45,65,110,0.409090909090909
"318",11,53,173,263,436,0.396788990825688
"319",11,54,154,140,294,0.523809523809524
"320",11,55,355,354,709,0.500705218617772
"321",11,56,145,150,295,0.491525423728814
"322",11,57,414,285,699,0.592274678111588
"323",11,58,59,61,120,0.491666666666667
"324",11,59,217,187,404,0.537128712871287
"325",11,60,195,182,377,0.517241379310345
"326",11,61,85,105,190,0.447368421052632
"327",11,62,501,505,1006,0.498011928429423
"328",11,63,130,144,274,0.474452554744526
"329",11,64,195,180,375,0.52
"330",11,65,67,72,139,0.482014388489209
"331",11,66,35,43,78,0.448717948717949
"332",11,67,515,351,866,0.594688221709007
"333",11,68,502,470,972,0.516460905349794
"334",11,69,664,562,1226,0.541598694942904
"335",11,70,276,200,476,0.579831932773109
"336",11,71,637,454,1091,0.583868010999083
"337",11,72,444,425,869,0.510932105868815
"338",11,73,263,286,549,0.479052823315118
"339",11,74,283,297,580,0.487931034482759
"340",11,75,510,429,939,0.543130990415335
"341",11,76,33,44,77,0.428571428571429
"342",11,77,57,66,123,0.463414634146341
"343",11,78,46,46,92,0.5
"344",11,79,82,124,206,0.398058252427184
"345",11,80,56,64,120,0.466666666666667
"346",11,81,139,129,268,0.51865671641791
"347",11,82,71,77,148,0.47972972972973
"348",11,83,123,108,231,0.532467532467532
"349",11,84,316,269,585,0.54017094017094
"350",11,85,465,344,809,0.574783683559951
"351",11,86,581,633,1214,0.478583196046128
"352",11,87,381,345,726,0.524793388429752
"353",11,88,168,179,347,0.484149855907781
"354",11,89,53,67,120,0.441666666666667
"355",11,90,137,134,271,0.505535055350554
"356",11,91,126,103,229,0.550218340611354
"357",11,92,70,59,129,0.542635658914729
"358",11,93,603,603,1206,0.5
"359",11,94,138,105,243,0.567901234567901
"360",11,95,100,79,179,0.558659217877095
"361",11,96,146,105,251,0.581673306772908
"362",11,97,162,213,375,0.432
"363",11,98,179,194,373,0.479892761394102
"364",11,99,257,242,499,0.51503006012024
"365",110,111,12,16,28,0.428571428571429
"366",110,112,121,116,237,0.510548523206751
"367",111,112,17,16,33,0.515151515151515
"368",12,100,128,144,272,0.470588235294118
"369",12,101,26,40,66,0.393939393939394
"370",12,102,45,47,92,0.489130434782609
"371",12,103,14,15,29,0.482758620689655
"372",12,104,76,112,188,0.404255319148936
"373",12,105,13,14,27,0.481481481481481
"374",12,106,52,90,142,0.366197183098592
"375",12,107,37,34,71,0.52112676056338
"376",12,109,9,12,21,0.428571428571429
"377",12,110,41,59,100,0.41
"378",12,111,11,19,30,0.366666666666667
"379",12,112,115,120,235,0.48936170212766
"380",12,13,11,33,44,0.25
"381",12,14,112,136,248,0.451612903225806
"382",12,15,18,18,36,0.5
"383",12,16,26,56,82,0.317073170731707
"384",12,17,24,43,67,0.358208955223881
"385",12,18,17,27,44,0.386363636363636
"386",12,19,44,58,102,0.431372549019608
"387",12,20,67,66,133,0.503759398496241
"388",12,21,249,342,591,0.421319796954315
"389",12,22,69,53,122,0.565573770491803
"390",12,23,24,32,56,0.428571428571429
"391",12,25,84,152,236,0.355932203389831
"392",12,26,85,152,237,0.358649789029536
"393",12,27,54,53,107,0.504672897196262
"394",12,28,119,116,235,0.506382978723404
"395",12,29,31,28,59,0.525423728813559
"396",12,30,100,142,242,0.413223140495868
"397",12,31,92,71,163,0.56441717791411
"398",12,32,48,48,96,0.5
"399",12,33,25,39,64,0.390625
"400",12,34,28,44,72,0.388888888888889
"401",12,35,33,39,72,0.458333333333333
"402",12,36,95,72,167,0.568862275449102
"403",12,37,29,31,60,0.483333333333333
"404",12,38,18,16,34,0.529411764705882
"405",12,39,107,183,290,0.368965517241379
"406",12,40,50,39,89,0.561797752808989
"407",12,41,13,26,39,0.333333333333333
"408",12,42,46,42,88,0.522727272727273
"409",12,43,26,20,46,0.565217391304348
"410",12,44,33,49,82,0.402439024390244
"411",12,45,20,22,42,0.476190476190476
"412",12,46,77,96,173,0.445086705202312
"413",12,47,51,52,103,0.495145631067961
"414",12,48,14,18,32,0.4375
"415",12,49,18,29,47,0.382978723404255
"416",12,50,153,142,295,0.51864406779661
"417",12,51,55,74,129,0.426356589147287
"418",12,52,14,25,39,0.358974358974359
"419",12,53,36,50,86,0.418604651162791
"420",12,54,17,30,47,0.361702127659574
"421",12,55,49,56,105,0.466666666666667
"422",12,56,18,26,44,0.409090909090909
"423",12,57,67,55,122,0.549180327868853
"424",12,58,6,15,21,0.285714285714286
"425",12,59,32,44,76,0.421052631578947
"426",12,60,25,54,79,0.316455696202532
"427",12,61,7,20,27,0.259259259259259
"428",12,62,79,106,185,0.427027027027027
"429",12,63,20,35,55,0.363636363636364
"430",12,64,40,49,89,0.449438202247191
"431",12,65,12,22,34,0.352941176470588
"432",12,66,6,8,14,0.428571428571429
"433",12,67,12,14,26,0.461538461538462
"434",12,68,93,113,206,0.451456310679612
"435",12,69,120,112,232,0.517241379310345
"436",12,70,36,36,72,0.5
"437",12,71,96,108,204,0.470588235294118
"438",12,72,21,30,51,0.411764705882353
"439",12,73,100,99,199,0.50251256281407
"440",12,74,165,228,393,0.419847328244275
"441",12,75,89,111,200,0.445
"442",12,76,24,27,51,0.470588235294118
"443",12,77,9,10,19,0.473684210526316
"444",12,78,12,15,27,0.444444444444444
"445",12,79,12,33,45,0.266666666666667
"446",12,80,14,11,25,0.56
"447",12,81,12,21,33,0.363636363636364
"448",12,82,10,19,29,0.344827586206897
"449",12,83,20,25,45,0.444444444444444
"450",12,84,75,62,137,0.547445255474453
"451",12,85,76,79,155,0.490322580645161
"452",12,86,83,147,230,0.360869565217391
"453",12,87,60,88,148,0.405405405405405
"454",12,88,33,41,74,0.445945945945946
"455",12,90,61,62,123,0.495934959349593
"456",12,91,11,21,32,0.34375
"457",12,92,9,13,22,0.409090909090909
"458",12,93,48,49,97,0.494845360824742
"459",12,94,13,13,26,0.5
"460",12,95,9,22,31,0.290322580645161
"461",12,96,20,27,47,0.425531914893617
"462",12,97,25,54,79,0.316455696202532
"463",12,98,27,45,72,0.375
"464",12,99,42,44,86,0.488372093023256
"465",13,100,44,72,116,0.379310344827586
"466",13,101,8,30,38,0.210526315789474
"467",13,102,21,14,35,0.6
"468",13,103,2,6,8,0.25
"469",13,104,54,68,122,0.442622950819672
"470",13,105,6,6,12,0.5
"471",13,106,29,41,70,0.414285714285714
"472",13,107,17,17,34,0.5
"473",13,109,16,8,24,0.666666666666667
"474",13,110,15,20,35,0.428571428571429
"475",13,111,10,10,20,0.5
"476",13,112,54,47,101,0.534653465346535
"477",13,14,50,64,114,0.43859649122807
"478",13,15,9,8,17,0.529411764705882
"479",13,16,17,28,45,0.377777777777778
"480",13,17,10,9,19,0.526315789473684
"481",13,18,27,28,55,0.490909090909091
"482",13,19,23,42,65,0.353846153846154
"483",13,20,26,45,71,0.366197183098592
"484",13,21,87,119,206,0.422330097087379
"485",13,22,13,14,27,0.481481481481481
"486",13,23,17,24,41,0.414634146341463
"487",13,25,26,48,74,0.351351351351351
"488",13,26,34,58,92,0.369565217391304
"489",13,27,28,17,45,0.622222222222222
"490",13,28,57,66,123,0.463414634146341
"491",13,29,14,16,30,0.466666666666667
"492",13,30,42,64,106,0.39622641509434
"493",13,31,22,28,50,0.44
"494",13,32,27,27,54,0.5
"495",13,33,18,29,47,0.382978723404255
"496",13,34,6,15,21,0.285714285714286
"497",13,35,21,26,47,0.446808510638298
"498",13,36,28,30,58,0.482758620689655
"499",13,37,5,11,16,0.3125
"500",13,38,7,11,18,0.388888888888889
"501",13,39,19,29,48,0.395833333333333
"502",13,40,19,24,43,0.441860465116279
"503",13,41,18,31,49,0.36734693877551
"504",13,42,57,54,111,0.513513513513513
"505",13,43,6,6,12,0.5
"506",13,44,46,58,104,0.442307692307692
"507",13,45,5,14,19,0.263157894736842
"508",13,46,19,30,49,0.387755102040816
"509",13,47,13,18,31,0.419354838709677
"510",13,48,13,25,38,0.342105263157895
"511",13,49,8,14,22,0.363636363636364
"512",13,50,37,65,102,0.362745098039216
"513",13,51,21,17,38,0.552631578947368
"514",13,52,4,12,16,0.25
"515",13,53,20,24,44,0.454545454545455
"516",13,54,18,19,37,0.486486486486487
"517",13,55,14,32,46,0.304347826086957
"518",13,56,11,25,36,0.305555555555556
"519",13,57,36,36,72,0.5
"520",13,58,4,9,13,0.307692307692308
"521",13,59,11,29,40,0.275
"522",13,60,9,17,26,0.346153846153846
"523",13,61,3,2,5,0.6
"524",13,62,36,58,94,0.382978723404255
"525",13,63,10,22,32,0.3125
"526",13,64,17,18,35,0.485714285714286
"527",13,67,52,50,102,0.509803921568627
"528",13,68,24,57,81,0.296296296296296
"529",13,69,38,55,93,0.408602150537634
"530",13,70,39,36,75,0.52
"531",13,71,47,50,97,0.484536082474227
"532",13,72,44,54,98,0.448979591836735
"533",13,73,48,46,94,0.51063829787234
"534",13,74,32,42,74,0.432432432432432
"535",13,75,27,42,69,0.391304347826087
"536",13,76,6,9,15,0.4
"537",13,77,9,6,15,0.6
"538",13,78,4,7,11,0.363636363636364
"539",13,79,3,6,9,0.333333333333333
"540",13,80,10,6,16,0.625
"541",13,81,17,24,41,0.414634146341463
"542",13,82,3,21,24,0.125
"543",13,83,11,14,25,0.44
"544",13,84,27,37,64,0.421875
"545",13,85,36,48,84,0.428571428571429
"546",13,86,46,67,113,0.407079646017699
"547",13,87,32,27,59,0.542372881355932
"548",13,88,13,21,34,0.382352941176471
"549",13,89,7,5,12,0.583333333333333
"550",13,90,5,20,25,0.2
"551",13,91,7,7,14,0.5
"552",13,92,6,6,12,0.5
"553",13,93,46,70,116,0.396551724137931
"554",13,94,20,15,35,0.571428571428571
"555",13,95,10,10,20,0.5
"556",13,96,6,14,20,0.3
"557",13,97,18,23,41,0.439024390243902
"558",13,98,13,20,33,0.393939393939394
"559",13,99,24,31,55,0.436363636363636
"560",14,100,258,328,586,0.440273037542662
"561",14,101,65,100,165,0.393939393939394
"562",14,102,118,77,195,0.605128205128205
"563",14,103,26,28,54,0.481481481481481
"564",14,104,331,381,712,0.464887640449438
"565",14,105,52,71,123,0.422764227642276
"566",14,106,171,243,414,0.41304347826087
"567",14,107,78,79,157,0.496815286624204
"568",14,109,70,63,133,0.526315789473684
"569",14,110,84,82,166,0.506024096385542
"570",14,111,34,39,73,0.465753424657534
"571",14,112,226,188,414,0.545893719806763
"572",14,15,43,61,104,0.413461538461538
"573",14,16,80,94,174,0.459770114942529
"574",14,17,59,75,134,0.440298507462687
"575",14,18,110,112,222,0.495495495495495
"576",14,19,141,189,330,0.427272727272727
"577",14,20,119,112,231,0.515151515151515
"578",14,21,671,724,1395,0.481003584229391
"579",14,22,134,124,258,0.51937984496124
"580",14,23,79,116,195,0.405128205128205
"581",14,25,208,300,508,0.409448818897638
"582",14,26,213,268,481,0.442827442827443
"583",14,27,125,120,245,0.510204081632653
"584",14,28,296,279,575,0.514782608695652
"585",14,29,66,58,124,0.532258064516129
"586",14,30,225,236,461,0.488069414316703
"587",14,31,126,90,216,0.583333333333333
"588",14,32,184,154,338,0.544378698224852
"589",14,33,69,74,143,0.482517482517482
"590",14,34,67,95,162,0.41358024691358
"591",14,35,133,164,297,0.447811447811448
"592",14,36,248,194,442,0.561085972850679
"593",14,37,66,48,114,0.578947368421053
"594",14,38,34,38,72,0.472222222222222
"595",14,39,275,304,579,0.474956822107081
"596",14,40,103,89,192,0.536458333333333
"597",14,41,121,158,279,0.433691756272401
"598",14,42,275,219,494,0.55668016194332
"599",14,43,44,54,98,0.448979591836735
"600",14,44,282,350,632,0.44620253164557
"601",14,45,59,65,124,0.475806451612903
"602",14,46,175,181,356,0.491573033707865
"603",14,47,112,116,228,0.491228070175439
"604",14,48,93,73,166,0.560240963855422
"605",14,49,58,72,130,0.446153846153846
"606",14,50,228,212,440,0.518181818181818
"607",14,51,117,115,232,0.504310344827586
"608",14,52,35,37,72,0.486111111111111
"609",14,53,107,147,254,0.421259842519685
"610",14,54,107,124,231,0.463203463203463
"611",14,55,120,120,240,0.5
"612",14,56,92,103,195,0.471794871794872
"613",14,57,225,145,370,0.608108108108108
"614",14,58,27,39,66,0.409090909090909
"615",14,59,128,149,277,0.462093862815884
"616",14,60,92,70,162,0.567901234567901
"617",14,61,38,52,90,0.422222222222222
"618",14,62,167,202,369,0.452574525745257
"619",14,63,95,89,184,0.516304347826087
"620",14,64,82,86,168,0.488095238095238
"621",14,65,34,29,63,0.53968253968254
"622",14,66,19,27,46,0.41304347826087
"623",14,67,271,201,472,0.574152542372881
"624",14,68,184,195,379,0.485488126649077
"625",14,69,214,205,419,0.510739856801909
"626",14,70,173,142,315,0.549206349206349
"627",14,71,211,181,392,0.538265306122449
"628",14,72,230,246,476,0.483193277310924
"629",14,73,363,328,691,0.525325615050651
"630",14,74,348,379,727,0.478679504814305
"631",14,75,258,216,474,0.544303797468354
"632",14,76,45,57,102,0.441176470588235
"633",14,77,31,24,55,0.563636363636364
"634",14,78,25,28,53,0.471698113207547
"635",14,79,32,48,80,0.4
"636",14,80,23,41,64,0.359375
"637",14,81,82,91,173,0.473988439306358
"638",14,82,47,57,104,0.451923076923077
"639",14,83,55,60,115,0.478260869565217
"640",14,84,121,114,235,0.514893617021277
"641",14,85,138,133,271,0.509225092250922
"642",14,86,225,242,467,0.481798715203426
"643",14,87,168,127,295,0.569491525423729
"644",14,88,77,87,164,0.469512195121951
"645",14,89,30,37,67,0.447761194029851
"646",14,90,81,76,157,0.515923566878981
"647",14,91,35,53,88,0.397727272727273
"648",14,92,19,36,55,0.345454545454545
"649",14,93,284,315,599,0.474123539232053
"650",14,94,89,88,177,0.502824858757062
"651",14,95,66,72,138,0.478260869565217
"652",14,96,62,58,120,0.516666666666667
"653",14,97,82,97,179,0.458100558659218
"654",14,98,77,86,163,0.47239263803681
"655",14,99,124,128,252,0.492063492063492
"656",15,100,78,87,165,0.472727272727273
"657",15,101,8,32,40,0.2
"658",15,102,28,33,61,0.459016393442623
"659",15,104,59,62,121,0.487603305785124
"660",15,106,39,36,75,0.52
"661",15,107,25,18,43,0.581395348837209
"662",15,109,7,10,17,0.411764705882353
"663",15,110,15,15,30,0.5
"664",15,111,8,11,19,0.421052631578947
"665",15,112,54,55,109,0.495412844036697
"666",15,16,19,38,57,0.333333333333333
"667",15,17,11,15,26,0.423076923076923
"668",15,18,19,16,35,0.542857142857143
"669",15,19,26,30,56,0.464285714285714
"670",15,20,29,26,55,0.527272727272727
"671",15,21,111,127,238,0.466386554621849
"672",15,22,32,33,65,0.492307692307692
"673",15,23,10,20,30,0.333333333333333
"674",15,25,33,56,89,0.370786516853933
"675",15,26,59,68,127,0.464566929133858
"676",15,27,35,34,69,0.507246376811594
"677",15,28,75,74,149,0.503355704697987
"678",15,29,16,20,36,0.444444444444444
"679",15,30,58,66,124,0.467741935483871
"680",15,31,31,31,62,0.5
"681",15,32,29,27,56,0.517857142857143
"682",15,33,24,27,51,0.470588235294118
"683",15,34,10,12,22,0.454545454545455
"684",15,35,18,40,58,0.310344827586207
"685",15,36,47,35,82,0.573170731707317
"686",15,37,20,15,35,0.571428571428571
"687",15,38,11,12,23,0.478260869565217
"688",15,39,58,55,113,0.513274336283186
"689",15,40,23,27,50,0.46
"690",15,41,16,28,44,0.363636363636364
"691",15,42,60,45,105,0.571428571428571
"692",15,43,5,17,22,0.227272727272727
"693",15,44,39,49,88,0.443181818181818
"694",15,45,10,14,24,0.416666666666667
"695",15,46,19,44,63,0.301587301587302
"696",15,47,18,24,42,0.428571428571429
"697",15,48,14,18,32,0.4375
"698",15,49,6,11,17,0.352941176470588
"699",15,50,71,61,132,0.537878787878788
"700",15,51,31,36,67,0.462686567164179
"701",15,52,10,6,16,0.625
"702",15,53,18,47,65,0.276923076923077
"703",15,54,13,15,28,0.464285714285714
"704",15,55,27,44,71,0.380281690140845
"705",15,56,15,18,33,0.454545454545455
"706",15,57,53,41,94,0.563829787234043
"707",15,59,27,18,45,0.6
"708",15,60,22,29,51,0.431372549019608
"709",15,61,6,10,16,0.375
"710",15,62,45,60,105,0.428571428571429
"711",15,63,10,20,30,0.333333333333333
"712",15,64,19,12,31,0.612903225806452
"713",15,65,4,9,13,0.307692307692308
"714",15,66,3,4,7,0.428571428571429
"715",15,67,37,32,69,0.536231884057971
"716",15,68,50,58,108,0.462962962962963
"717",15,69,44,41,85,0.517647058823529
"718",15,70,44,36,80,0.55
"719",15,71,50,48,98,0.510204081632653
"720",15,72,33,45,78,0.423076923076923
"721",15,73,59,59,118,0.5
"722",15,74,50,67,117,0.427350427350427
"723",15,75,37,42,79,0.468354430379747
"724",15,76,8,12,20,0.4
"725",15,78,4,6,10,0.4
"726",15,79,12,10,22,0.545454545454545
"727",15,80,3,7,10,0.3
"728",15,81,20,23,43,0.465116279069767
"729",15,83,16,23,39,0.41025641025641
"730",15,84,41,44,85,0.482352941176471
"731",15,85,59,46,105,0.561904761904762
"732",15,86,60,82,142,0.422535211267606
"733",15,87,48,43,91,0.527472527472527
"734",15,88,22,19,41,0.536585365853659
"735",15,89,6,10,16,0.375
"736",15,90,18,13,31,0.580645161290323
"737",15,91,14,14,28,0.5
"738",15,92,7,20,27,0.259259259259259
"739",15,93,35,53,88,0.397727272727273
"740",15,94,11,20,31,0.354838709677419
"741",15,95,7,11,18,0.388888888888889
"742",15,96,15,16,31,0.483870967741935
"743",15,97,12,20,32,0.375
"744",15,98,19,27,46,0.41304347826087
"745",15,99,21,36,57,0.368421052631579
"746",16,100,78,103,181,0.430939226519337
"747",16,101,14,44,58,0.241379310344828
"748",16,102,38,33,71,0.535211267605634
"749",16,103,9,9,18,0.5
"750",16,104,83,87,170,0.488235294117647
"751",16,105,6,7,13,0.461538461538462
"752",16,106,73,105,178,0.410112359550562
"753",16,107,27,32,59,0.457627118644068
"754",16,109,15,19,34,0.441176470588235
"755",16,110,27,31,58,0.46551724137931
"756",16,111,7,12,19,0.368421052631579
"757",16,112,56,69,125,0.448
"758",16,17,24,43,67,0.358208955223881
"759",16,18,28,41,69,0.405797101449275
"760",16,19,61,58,119,0.512605042016807
"761",16,20,31,39,70,0.442857142857143
"762",16,21,235,293,528,0.445075757575758
"763",16,22,52,50,102,0.509803921568627
"764",16,23,25,31,56,0.446428571428571
"765",16,25,80,124,204,0.392156862745098
"766",16,26,45,78,123,0.365853658536585
"767",16,27,34,22,56,0.607142857142857
"768",16,28,109,104,213,0.511737089201878
"769",16,29,22,24,46,0.478260869565217
"770",16,30,55,80,135,0.407407407407407
"771",16,31,37,44,81,0.45679012345679
"772",16,32,47,37,84,0.55952380952381
"773",16,33,17,17,34,0.5
"774",16,34,24,34,58,0.413793103448276
"775",16,35,40,57,97,0.412371134020619
"776",16,36,72,56,128,0.5625
"777",16,37,23,22,45,0.511111111111111
"778",16,38,13,14,27,0.481481481481481
"779",16,39,102,150,252,0.404761904761905
"780",16,40,30,32,62,0.483870967741935
"781",16,41,36,37,73,0.493150684931507
"782",16,42,98,69,167,0.586826347305389
"783",16,43,24,23,47,0.51063829787234
"784",16,44,75,132,207,0.36231884057971
"785",16,45,20,19,39,0.512820512820513
"786",16,46,81,91,172,0.47093023255814
"787",16,47,43,38,81,0.530864197530864
"788",16,48,26,34,60,0.433333333333333
"789",16,49,20,24,44,0.454545454545455
"790",16,50,76,70,146,0.520547945205479
"791",16,51,45,59,104,0.432692307692308
"792",16,52,17,22,39,0.435897435897436
"793",16,53,15,32,47,0.319148936170213
"794",16,54,11,24,35,0.314285714285714
"795",16,55,51,61,112,0.455357142857143
"796",16,56,32,33,65,0.492307692307692
"797",16,57,58,31,89,0.651685393258427
"798",16,58,9,13,22,0.409090909090909
"799",16,59,44,41,85,0.517647058823529
"800",16,60,33,30,63,0.523809523809524
"801",16,61,11,22,33,0.333333333333333
"802",16,62,44,45,89,0.49438202247191
"803",16,63,32,29,61,0.524590163934426
"804",16,64,24,39,63,0.380952380952381
"805",16,65,9,13,22,0.409090909090909
"806",16,67,95,73,168,0.56547619047619
"807",16,68,70,67,137,0.510948905109489
"808",16,69,56,72,128,0.4375
"809",16,70,43,31,74,0.581081081081081
"810",16,71,57,76,133,0.428571428571429
"811",16,72,76,79,155,0.490322580645161
"812",16,73,105,123,228,0.460526315789474
"813",16,74,139,155,294,0.472789115646259
"814",16,75,85,70,155,0.548387096774194
"815",16,76,24,22,46,0.521739130434783
"816",16,77,9,5,14,0.642857142857143
"817",16,78,11,11,22,0.5
"818",16,79,9,10,19,0.473684210526316
"819",16,80,8,15,23,0.347826086956522
"820",16,81,26,26,52,0.5
"821",16,82,22,10,32,0.6875
"822",16,83,15,15,30,0.5
"823",16,84,26,42,68,0.382352941176471
"824",16,85,51,39,90,0.566666666666667
"825",16,86,59,95,154,0.383116883116883
"826",16,87,44,39,83,0.530120481927711
"827",16,88,25,26,51,0.490196078431373
"828",16,89,13,17,30,0.433333333333333
"829",16,90,19,22,41,0.463414634146341
"830",16,91,9,13,22,0.409090909090909
"831",16,92,6,6,12,0.5
"832",16,93,80,102,182,0.43956043956044
"833",16,94,40,37,77,0.519480519480519
"834",16,95,21,27,48,0.4375
"835",16,96,17,19,36,0.472222222222222
"836",16,97,38,44,82,0.463414634146341
"837",16,98,46,47,93,0.494623655913978
"838",16,99,35,56,91,0.384615384615385
"839",17,100,68,97,165,0.412121212121212
"840",17,101,16,29,45,0.355555555555556
"841",17,102,25,35,60,0.416666666666667
"842",17,103,4,6,10,0.4
"843",17,104,76,130,206,0.368932038834951
"844",17,105,9,18,27,0.333333333333333
"845",17,106,17,41,58,0.293103448275862
"846",17,107,18,27,45,0.4
"847",17,109,10,14,24,0.416666666666667
"848",17,110,18,23,41,0.439024390243902
"849",17,112,39,80,119,0.327731092436975
"850",17,18,38,29,67,0.567164179104478
"851",17,19,26,53,79,0.329113924050633
"852",17,20,32,40,72,0.444444444444444
"853",17,21,110,147,257,0.428015564202335
"854",17,22,31,24,55,0.563636363636364
"855",17,23,14,26,40,0.35
"856",17,25,36,82,118,0.305084745762712
"857",17,26,52,81,133,0.390977443609023
"858",17,27,29,27,56,0.517857142857143
"859",17,28,94,98,192,0.489583333333333
"860",17,29,20,31,51,0.392156862745098
"861",17,30,57,82,139,0.410071942446043
"862",17,31,42,38,80,0.525
"863",17,32,47,42,89,0.528089887640449
"864",17,33,14,29,43,0.325581395348837
"865",17,34,4,10,14,0.285714285714286
"866",17,35,20,47,67,0.298507462686567
"867",17,36,55,60,115,0.478260869565217
"868",17,37,20,15,35,0.571428571428571
"869",17,38,6,13,19,0.315789473684211
"870",17,39,21,39,60,0.35
"871",17,40,20,41,61,0.327868852459016
"872",17,41,25,32,57,0.43859649122807
"873",17,42,52,59,111,0.468468468468468
"874",17,43,8,7,15,0.533333333333333
"875",17,44,52,104,156,0.333333333333333
"876",17,45,11,10,21,0.523809523809524
"877",17,46,14,23,37,0.378378378378378
"878",17,47,13,23,36,0.361111111111111
"879",17,48,15,24,39,0.384615384615385
"880",17,49,6,18,24,0.25
"881",17,50,68,72,140,0.485714285714286
"882",17,51,40,38,78,0.512820512820513
"883",17,52,10,8,18,0.555555555555556
"884",17,53,17,53,70,0.242857142857143
"885",17,54,28,42,70,0.4
"886",17,55,30,30,60,0.5
"887",17,56,17,31,48,0.354166666666667
"888",17,57,52,53,105,0.495238095238095
"889",17,58,7,12,19,0.368421052631579
"890",17,59,25,42,67,0.373134328358209
"891",17,60,15,34,49,0.306122448979592
"892",17,61,16,24,40,0.4
"893",17,62,62,64,126,0.492063492063492
"894",17,63,19,37,56,0.339285714285714
"895",17,64,25,23,48,0.520833333333333
"896",17,65,6,11,17,0.352941176470588
"897",17,66,11,11,22,0.5
"898",17,67,60,61,121,0.495867768595041
"899",17,68,53,58,111,0.477477477477477
"900",17,69,57,91,148,0.385135135135135
"901",17,70,57,48,105,0.542857142857143
"902",17,71,64,76,140,0.457142857142857
"903",17,72,41,56,97,0.422680412371134
"904",17,73,40,62,102,0.392156862745098
"905",17,74,47,50,97,0.484536082474227
"906",17,75,69,88,157,0.439490445859873
"907",17,76,2,13,15,0.133333333333333
"908",17,77,8,18,26,0.307692307692308
"909",17,78,8,13,21,0.380952380952381
"910",17,79,8,19,27,0.296296296296296
"911",17,80,8,6,14,0.571428571428571
"912",17,81,21,29,50,0.42
"913",17,82,7,13,20,0.35
"914",17,83,7,20,27,0.259259259259259
"915",17,84,38,47,85,0.447058823529412
"916",17,85,52,43,95,0.547368421052632
"917",17,86,42,101,143,0.293706293706294
"918",17,87,33,48,81,0.407407407407407
"919",17,88,17,28,45,0.377777777777778
"920",17,89,3,14,17,0.176470588235294
"921",17,90,23,25,48,0.479166666666667
"922",17,91,6,34,40,0.15
"923",17,92,3,5,8,0.375
"924",17,93,68,78,146,0.465753424657534
"925",17,94,27,20,47,0.574468085106383
"926",17,95,17,22,39,0.435897435897436
"927",17,96,16,21,37,0.432432432432432
"928",17,97,15,23,38,0.394736842105263
"929",17,98,24,38,62,0.387096774193548
"930",17,99,38,49,87,0.436781609195402
"931",18,100,122,122,244,0.5
"932",18,101,26,51,77,0.337662337662338
"933",18,102,38,32,70,0.542857142857143
"934",18,103,15,12,27,0.555555555555556
"935",18,104,85,69,154,0.551948051948052
"936",18,105,17,20,37,0.459459459459459
"937",18,106,71,74,145,0.489655172413793
"938",18,107,34,34,68,0.5
"939",18,109,10,14,24,0.416666666666667
"940",18,110,41,38,79,0.518987341772152
"941",18,111,13,13,26,0.5
"942",18,112,100,108,208,0.480769230769231
"943",18,19,44,40,84,0.523809523809524
"944",18,20,76,63,139,0.546762589928058
"945",18,21,252,266,518,0.486486486486487
"946",18,22,66,71,137,0.481751824817518
"947",18,23,21,32,53,0.39622641509434
"948",18,25,102,140,242,0.421487603305785
"949",18,26,103,106,209,0.492822966507177
"950",18,27,49,42,91,0.538461538461538
"951",18,28,129,78,207,0.623188405797101
"952",18,29,43,29,72,0.597222222222222
"953",18,30,114,98,212,0.537735849056604
"954",18,31,83,45,128,0.6484375
"955",18,32,55,33,88,0.625
"956",18,33,46,47,93,0.494623655913978
"957",18,34,31,36,67,0.462686567164179
"958",18,35,44,63,107,0.411214953271028
"959",18,36,102,78,180,0.566666666666667
"960",18,37,36,30,66,0.545454545454545
"961",18,38,18,13,31,0.580645161290323
"962",18,39,122,153,275,0.443636363636364
"963",18,40,48,49,97,0.494845360824742
"964",18,41,10,13,23,0.434782608695652
"965",18,42,44,32,76,0.578947368421053
"966",18,43,36,18,54,0.666666666666667
"967",18,44,34,50,84,0.404761904761905
"968",18,45,18,26,44,0.409090909090909
"969",18,46,73,70,143,0.510489510489511
"970",18,47,59,48,107,0.551401869158878
"971",18,48,19,9,28,0.678571428571429
"972",18,49,22,16,38,0.578947368421053
"973",18,50,113,101,214,0.52803738317757
"974",18,51,43,42,85,0.505882352941176
"975",18,52,22,21,43,0.511627906976744
"976",18,53,29,66,95,0.305263157894737
"977",18,54,15,21,36,0.416666666666667
"978",18,55,85,61,146,0.582191780821918
"979",18,56,25,32,57,0.43859649122807
"980",18,57,122,66,188,0.648936170212766
"981",18,58,11,22,33,0.333333333333333
"982",18,59,40,32,72,0.555555555555556
"983",18,60,32,29,61,0.524590163934426
"984",18,61,14,19,33,0.424242424242424
"985",18,62,81,85,166,0.487951807228916
"986",18,63,26,31,57,0.456140350877193
"987",18,64,38,46,84,0.452380952380952
"988",18,65,5,14,19,0.263157894736842
"989",18,66,8,9,17,0.470588235294118
"990",18,67,46,25,71,0.647887323943662
"991",18,68,99,80,179,0.553072625698324
"992",18,69,103,74,177,0.581920903954802
"993",18,70,39,34,73,0.534246575342466
"994",18,71,73,67,140,0.521428571428571
"995",18,72,28,51,79,0.354430379746835
"996",18,73,113,111,224,0.504464285714286
"997",18,74,150,164,314,0.477707006369427
"998",18,75,116,95,211,0.549763033175355
"999",18,76,21,15,36,0.583333333333333
"1000",18,77,13,16,29,0.448275862068966
"1001",18,78,14,13,27,0.518518518518518
"1002",18,79,12,18,30,0.4
"1003",18,80,6,10,16,0.375
"1004",18,81,13,14,27,0.481481481481481
"1005",18,82,16,22,38,0.421052631578947
"1006",18,83,25,31,56,0.446428571428571
"1007",18,84,56,59,115,0.48695652173913
"1008",18,85,98,56,154,0.636363636363636
"1009",18,86,78,99,177,0.440677966101695
"1010",18,87,64,78,142,0.450704225352113
"1011",18,88,25,40,65,0.384615384615385
"1012",18,89,8,9,17,0.470588235294118
"1013",18,90,39,35,74,0.527027027027027
"1014",18,91,36,32,68,0.529411764705882
"1015",18,92,6,14,20,0.3
"1016",18,93,59,50,109,0.541284403669725
"1017",18,94,30,13,43,0.697674418604651
"1018",18,95,14,19,33,0.424242424242424
"1019",18,96,20,25,45,0.444444444444444
"1020",18,97,89,98,187,0.475935828877005
"1021",18,98,37,46,83,0.44578313253012
"1022",18,99,36,48,84,0.428571428571429
"1023",19,100,181,213,394,0.459390862944162
"1024",19,101,53,57,110,0.481818181818182
"1025",19,102,78,55,133,0.586466165413534
"1026",19,103,17,16,33,0.515151515151515
"1027",19,104,149,165,314,0.474522292993631
"1028",19,105,37,36,73,0.506849315068493
"1029",19,106,102,125,227,0.449339207048458
"1030",19,107,37,53,90,0.411111111111111
"1031",19,109,29,22,51,0.568627450980392
"1032",19,110,58,61,119,0.487394957983193
"1033",19,111,16,22,38,0.421052631578947
"1034",19,112,148,143,291,0.508591065292096
"1035",19,20,95,74,169,0.562130177514793
"1036",19,21,364,450,814,0.447174447174447
"1037",19,22,85,72,157,0.54140127388535
"1038",19,23,28,51,79,0.354430379746835
"1039",19,25,115,175,290,0.396551724137931
"1040",19,26,160,171,331,0.483383685800604
"1041",19,27,69,69,138,0.5
"1042",19,28,207,170,377,0.549071618037135
"1043",19,29,28,40,68,0.411764705882353
"1044",19,30,153,153,306,0.5
"1045",19,31,92,86,178,0.51685393258427
"1046",19,32,99,82,181,0.546961325966851
"1047",19,33,49,58,107,0.457943925233645
"1048",19,34,30,51,81,0.37037037037037
"1049",19,35,59,70,129,0.457364341085271
"1050",19,36,116,114,230,0.504347826086956
"1051",19,37,36,32,68,0.529411764705882
"1052",19,38,28,21,49,0.571428571428571
"1053",19,39,140,199,339,0.412979351032448
"1054",19,40,60,66,126,0.476190476190476
"1055",19,41,26,51,77,0.337662337662338
"1056",19,42,115,98,213,0.539906103286385
"1057",19,43,38,25,63,0.603174603174603
"1058",19,44,114,127,241,0.473029045643154
"1059",19,45,27,32,59,0.457627118644068
"1060",19,46,69,96,165,0.418181818181818
"1061",19,47,64,58,122,0.524590163934426
"1062",19,48,40,32,72,0.555555555555556
"1063",19,49,22,40,62,0.354838709677419
"1064",19,50,171,142,313,0.546325878594249
"1065",19,51,85,77,162,0.524691358024691
"1066",19,52,12,32,44,0.272727272727273
"1067",19,53,63,95,158,0.39873417721519
"1068",19,54,38,41,79,0.481012658227848
"1069",19,55,72,85,157,0.45859872611465
"1070",19,56,25,67,92,0.271739130434783
"1071",19,57,135,94,229,0.589519650655022
"1072",19,58,17,23,40,0.425
"1073",19,59,52,77,129,0.403100775193798
"1074",19,60,45,46,91,0.494505494505495
"1075",19,61,24,32,56,0.428571428571429
"1076",19,62,133,148,281,0.473309608540925
"1077",19,63,44,45,89,0.49438202247191
"1078",19,64,53,70,123,0.430894308943089
"1079",19,65,17,15,32,0.53125
"1080",19,66,12,5,17,0.705882352941177
"1081",19,67,101,75,176,0.573863636363636
"1082",19,68,134,152,286,0.468531468531469
"1083",19,69,146,127,273,0.534798534798535
"1084",19,70,87,60,147,0.591836734693878
"1085",19,71,116,131,247,0.469635627530364
"1086",19,72,90,104,194,0.463917525773196
"1087",19,73,150,159,309,0.485436893203884
"1088",19,74,164,198,362,0.453038674033149
"1089",19,75,168,155,323,0.520123839009288
"1090",19,76,14,36,50,0.28
"1091",19,77,21,17,38,0.552631578947368
"1092",19,78,10,15,25,0.4
"1093",19,79,13,41,54,0.240740740740741
"1094",19,80,12,19,31,0.387096774193548
"1095",19,81,34,30,64,0.53125
"1096",19,82,25,37,62,0.403225806451613
"1097",19,83,24,36,60,0.4
"1098",19,84,81,85,166,0.487951807228916
"1099",19,85,111,109,220,0.504545454545455
"1100",19,86,133,212,345,0.385507246376812
"1101",19,87,82,99,181,0.453038674033149
"1102",19,88,60,49,109,0.55045871559633
"1103",19,89,13,22,35,0.371428571428571
"1104",19,90,55,74,129,0.426356589147287
"1105",19,91,198,259,457,0.433260393873085
"1106",19,92,21,16,37,0.567567567567568
"1107",19,93,116,123,239,0.485355648535565
"1108",19,94,43,30,73,0.589041095890411
"1109",19,95,33,34,67,0.492537313432836
"1110",19,96,40,54,94,0.425531914893617
"1111",19,97,54,66,120,0.45
"1112",19,98,48,63,111,0.432432432432432
"1113",19,99,50,73,123,0.40650406504065
"1114",2,10,26,40,66,0.393939393939394
"1115",2,100,101,129,230,0.439130434782609
"1116",2,101,34,68,102,0.333333333333333
"1117",2,102,57,52,109,0.522935779816514
"1118",2,103,10,12,22,0.454545454545455
"1119",2,104,104,158,262,0.396946564885496
"1120",2,105,10,19,29,0.344827586206897
"1121",2,106,96,141,237,0.40506329113924
"1122",2,107,31,41,72,0.430555555555556
"1123",2,109,25,29,54,0.462962962962963
"1124",2,11,259,324,583,0.444253859348199
"1125",2,110,38,38,76,0.5
"1126",2,111,14,24,38,0.368421052631579
"1127",2,112,101,140,241,0.419087136929461
"1128",2,12,53,100,153,0.34640522875817
"1129",2,13,25,43,68,0.367647058823529
"1130",2,14,106,151,257,0.412451361867704
"1131",2,15,30,46,76,0.394736842105263
"1132",2,16,31,50,81,0.382716049382716
"1133",2,17,30,68,98,0.306122448979592
"1134",2,18,43,52,95,0.452631578947368
"1135",2,19,66,84,150,0.44
"1136",2,20,56,80,136,0.411764705882353
"1137",2,21,316,440,756,0.417989417989418
"1138",2,22,83,78,161,0.515527950310559
"1139",2,23,26,38,64,0.40625
"1140",2,25,103,185,288,0.357638888888889
"1141",2,26,102,130,232,0.439655172413793
"1142",2,27,51,67,118,0.432203389830508
"1143",2,28,88,137,225,0.391111111111111
"1144",2,29,21,32,53,0.39622641509434
"1145",2,3,36,41,77,0.467532467532468
"1146",2,30,124,141,265,0.467924528301887
"1147",2,31,64,77,141,0.453900709219858
"1148",2,32,68,74,142,0.47887323943662
"1149",2,33,29,21,50,0.58
"1150",2,34,41,65,106,0.386792452830189
"1151",2,35,64,112,176,0.363636363636364
"1152",2,36,92,125,217,0.423963133640553
"1153",2,37,36,42,78,0.461538461538462
"1154",2,38,12,13,25,0.48
"1155",2,39,121,224,345,0.350724637681159
"1156",2,4,33,41,74,0.445945945945946
"1157",2,40,46,55,101,0.455445544554455
"1158",2,41,54,65,119,0.453781512605042
"1159",2,42,115,91,206,0.558252427184466
"1160",2,43,37,38,75,0.493333333333333
"1161",2,44,128,164,292,0.438356164383562
"1162",2,45,18,28,46,0.391304347826087
"1163",2,46,96,144,240,0.4
"1164",2,47,64,70,134,0.477611940298507
"1165",2,48,38,55,93,0.408602150537634
"1166",2,49,25,31,56,0.446428571428571
"1167",2,5,134,139,273,0.490842490842491
"1168",2,50,165,171,336,0.491071428571429
"1169",2,51,39,52,91,0.428571428571429
"1170",2,52,17,25,42,0.404761904761905
"1171",2,53,37,41,78,0.474358974358974
"1172",2,54,28,38,66,0.424242424242424
"1173",2,55,62,67,129,0.48062015503876
"1174",2,56,40,45,85,0.470588235294118
"1175",2,57,125,93,218,0.573394495412844
"1176",2,58,9,13,22,0.409090909090909
"1177",2,59,46,70,116,0.396551724137931
"1178",2,6,59,47,106,0.556603773584906
"1179",2,60,34,44,78,0.435897435897436
"1180",2,61,15,32,47,0.319148936170213
"1181",2,62,72,104,176,0.409090909090909
"1182",2,63,41,66,107,0.383177570093458
"1183",2,64,44,56,100,0.44
"1184",2,65,11,24,35,0.314285714285714
"1185",2,66,5,6,11,0.454545454545455
"1186",2,67,103,120,223,0.461883408071749
"1187",2,68,113,144,257,0.439688715953307
"1188",2,69,51,77,128,0.3984375
"1189",2,7,120,170,290,0.413793103448276
"1190",2,70,60,53,113,0.530973451327434
"1191",2,71,62,83,145,0.427586206896552
"1192",2,72,102,149,251,0.406374501992032
"1193",2,73,139,190,329,0.422492401215805
"1194",2,74,189,256,445,0.424719101123596
"1195",2,75,134,124,258,0.51937984496124
"1196",2,76,22,32,54,0.407407407407407
"1197",2,77,7,15,22,0.318181818181818
"1198",2,78,10,9,19,0.526315789473684
"1199",2,79,12,32,44,0.272727272727273
"1200",2,8,172,193,365,0.471232876712329
"1201",2,80,5,19,24,0.208333333333333
"1202",2,81,28,42,70,0.4
"1203",2,82,19,32,51,0.372549019607843
"1204",2,83,18,21,39,0.461538461538462
"1205",2,84,52,59,111,0.468468468468468
"1206",2,85,70,62,132,0.53030303030303
"1207",2,86,79,147,226,0.349557522123894
"1208",2,87,62,84,146,0.424657534246575
"1209",2,88,31,51,82,0.378048780487805
"1210",2,89,11,17,28,0.392857142857143
"1211",2,9,93,112,205,0.453658536585366
"1212",2,90,33,45,78,0.423076923076923
"1213",2,91,12,25,37,0.324324324324324
"1214",2,92,9,15,24,0.375
"1215",2,93,125,178,303,0.412541254125413
"1216",2,94,37,43,80,0.4625
"1217",2,95,27,43,70,0.385714285714286
"1218",2,96,16,11,27,0.592592592592593
"1219",2,97,25,73,98,0.255102040816327
"1220",2,98,21,37,58,0.362068965517241
"1221",2,99,40,43,83,0.481927710843373
"1222",20,100,149,147,296,0.503378378378378
"1223",20,101,24,39,63,0.380952380952381
"1224",20,102,40,47,87,0.459770114942529
"1225",20,103,16,13,29,0.551724137931034
"1226",20,104,135,129,264,0.511363636363636
"1227",20,105,16,11,27,0.592592592592593
"1228",20,106,118,118,236,0.5
"1229",20,107,34,38,72,0.472222222222222
"1230",20,109,29,23,52,0.557692307692308
"1231",20,110,51,35,86,0.593023255813954
"1232",20,111,10,7,17,0.588235294117647
"1233",20,112,75,55,130,0.576923076923077
"1234",20,21,342,332,674,0.507418397626113
"1235",20,22,53,70,123,0.430894308943089
"1236",20,23,31,39,70,0.442857142857143
"1237",20,25,110,123,233,0.472103004291845
"1238",20,26,58,51,109,0.532110091743119
"1239",20,27,30,22,52,0.576923076923077
"1240",20,28,258,191,449,0.574610244988864
"1241",20,29,36,30,66,0.545454545454545
"1242",20,30,65,63,128,0.5078125
"1243",20,31,63,42,105,0.6
"1244",20,32,83,46,129,0.643410852713178
"1245",20,33,29,26,55,0.527272727272727
"1246",20,34,42,40,82,0.51219512195122
"1247",20,35,65,62,127,0.511811023622047
"1248",20,36,93,52,145,0.641379310344828
"1249",20,37,26,15,41,0.634146341463415
"1250",20,38,22,16,38,0.578947368421053
"1251",20,39,157,185,342,0.45906432748538
"1252",20,40,34,29,63,0.53968253968254
"1253",20,41,42,60,102,0.411764705882353
"1254",20,42,177,108,285,0.621052631578947
"1255",20,43,30,22,52,0.576923076923077
"1256",20,44,120,129,249,0.481927710843373
"1257",20,45,16,15,31,0.516129032258065
"1258",20,46,117,95,212,0.55188679245283
"1259",20,47,66,62,128,0.515625
"1260",20,48,56,56,112,0.5
"1261",20,49,43,30,73,0.589041095890411
"1262",20,50,91,64,155,0.587096774193548
"1263",20,51,76,75,151,0.503311258278146
"1264",20,52,15,19,34,0.441176470588235
"1265",20,53,45,58,103,0.436893203883495
"1266",20,54,42,40,82,0.51219512195122
"1267",20,55,66,53,119,0.554621848739496
"1268",20,56,39,42,81,0.481481481481481
"1269",20,57,75,40,115,0.652173913043478
"1270",20,58,7,17,24,0.291666666666667
"1271",20,59,41,42,83,0.493975903614458
"1272",20,60,62,47,109,0.568807339449541
"1273",20,61,20,17,37,0.540540540540541
"1274",20,62,86,84,170,0.505882352941176
"1275",20,63,44,51,95,0.463157894736842
"1276",20,64,33,24,57,0.578947368421053
"1277",20,65,16,21,37,0.432432432432432
"1278",20,67,121,78,199,0.608040201005025
"1279",20,68,73,76,149,0.48993288590604
"1280",20,69,141,116,257,0.54863813229572
"1281",20,70,59,69,128,0.4609375
"1282",20,71,104,91,195,0.533333333333333
"1283",20,72,128,90,218,0.587155963302752
"1284",20,73,173,135,308,0.561688311688312
"1285",20,74,200,157,357,0.560224089635854
"1286",20,75,87,85,172,0.505813953488372
"1287",20,76,26,26,52,0.5
"1288",20,77,13,16,29,0.448275862068966
"1289",20,78,20,11,31,0.645161290322581
"1290",20,79,8,10,18,0.444444444444444
"1291",20,80,20,14,34,0.588235294117647
"1292",20,81,52,37,89,0.584269662921348
"1293",20,82,19,28,47,0.404255319148936
"1294",20,83,34,18,52,0.653846153846154
"1295",20,84,43,47,90,0.477777777777778
"1296",20,85,91,55,146,0.623287671232877
"1297",20,86,70,76,146,0.479452054794521
"1298",20,87,57,24,81,0.703703703703704
"1299",20,88,39,32,71,0.549295774647887
"1300",20,89,16,11,27,0.592592592592593
"1301",20,90,28,24,52,0.538461538461538
"1302",20,91,23,22,45,0.511111111111111
"1303",20,92,23,12,35,0.657142857142857
"1304",20,93,147,160,307,0.478827361563518
"1305",20,94,51,25,76,0.671052631578947
"1306",20,95,37,31,68,0.544117647058823
"1307",20,96,30,29,59,0.508474576271186
"1308",20,97,58,45,103,0.563106796116505
"1309",20,98,45,56,101,0.445544554455446
"1310",20,99,64,62,126,0.507936507936508
"1311",21,100,777,829,1606,0.483810709838107
"1312",21,101,198,271,469,0.422174840085288
"1313",21,102,320,240,560,0.571428571428571
"1314",21,103,73,51,124,0.588709677419355
"1315",21,104,643,762,1405,0.457651245551601
"1316",21,105,78,110,188,0.414893617021277
"1317",21,106,435,525,960,0.453125
"1318",21,107,224,212,436,0.513761467889908
"1319",21,109,118,108,226,0.52212389380531
"1320",21,110,207,211,418,0.495215311004785
"1321",21,111,67,95,162,0.41358024691358
"1322",21,112,649,671,1320,0.491666666666667
"1323",21,22,294,234,528,0.556818181818182
"1324",21,23,154,197,351,0.438746438746439
"1325",21,25,420,654,1074,0.391061452513966
"1326",21,26,517,709,1226,0.421696574225122
"1327",21,27,293,272,565,0.51858407079646
"1328",21,28,1008,850,1858,0.542518837459634
"1329",21,29,149,177,326,0.457055214723926
"1330",21,30,535,618,1153,0.464006938421509
"1331",21,31,399,339,738,0.540650406504065
"1332",21,32,322,278,600,0.536666666666667
"1333",21,33,201,226,427,0.470725995316159
"1334",21,34,103,152,255,0.403921568627451
"1335",21,35,158,240,398,0.396984924623116
"1336",21,36,424,382,806,0.52605459057072
"1337",21,37,181,136,317,0.570977917981073
"1338",21,38,74,106,180,0.411111111111111
"1339",21,39,454,684,1138,0.398945518453427
"1340",21,40,246,194,440,0.559090909090909
"1341",21,41,218,286,504,0.432539682539683
"1342",21,42,724,605,1329,0.54477050413845
"1343",21,43,95,91,186,0.510752688172043
"1344",21,44,455,622,1077,0.42246982358403
"1345",21,45,86,119,205,0.419512195121951
"1346",21,46,269,315,584,0.460616438356164
"1347",21,47,216,214,430,0.502325581395349
"1348",21,48,184,168,352,0.522727272727273
"1349",21,49,110,151,261,0.421455938697318
"1350",21,50,711,711,1422,0.5
"1351",21,51,265,320,585,0.452991452991453
"1352",21,52,75,119,194,0.38659793814433
"1353",21,53,221,334,555,0.398198198198198
"1354",21,54,177,236,413,0.428571428571429
"1355",21,55,270,277,547,0.493601462522852
"1356",21,56,150,190,340,0.441176470588235
"1357",21,57,497,396,893,0.556550951847704
"1358",21,58,55,100,155,0.354838709677419
"1359",21,59,258,235,493,0.523326572008114
"1360",21,60,229,234,463,0.494600431965443
"1361",21,61,61,105,166,0.367469879518072
"1362",21,62,594,605,1199,0.495412844036697
"1363",21,63,167,186,353,0.473087818696884
"1364",21,64,214,237,451,0.47450110864745
"1365",21,65,69,76,145,0.475862068965517
"1366",21,66,46,55,101,0.455445544554455
"1367",21,67,621,487,1108,0.560469314079422
"1368",21,68,529,575,1104,0.479166666666667
"1369",21,69,619,651,1270,0.48740157480315
"1370",21,70,408,280,688,0.593023255813954
"1371",21,71,604,536,1140,0.529824561403509
"1372",21,72,493,530,1023,0.481915933528837
"1373",21,73,618,637,1255,0.492430278884462
"1374",21,74,572,701,1273,0.449332285938727
"1375",21,75,583,570,1153,0.505637467476149
"1376",21,76,74,109,183,0.404371584699454
"1377",21,77,80,79,159,0.50314465408805
"1378",21,78,58,72,130,0.446153846153846
"1379",21,79,97,150,247,0.392712550607287
"1380",21,80,57,75,132,0.431818181818182
"1381",21,81,156,188,344,0.453488372093023
"1382",21,82,101,122,223,0.452914798206278
"1383",21,83,148,142,290,0.510344827586207
"1384",21,84,357,361,718,0.497214484679666
"1385",21,85,537,415,952,0.564075630252101
"1386",21,86,596,827,1423,0.418833450456781
"1387",21,87,416,354,770,0.54025974025974
"1388",21,88,182,227,409,0.444987775061125
"1389",21,89,60,68,128,0.46875
"1390",21,90,179,184,363,0.493112947658402
"1391",21,91,90,154,244,0.368852459016393
"1392",21,92,82,80,162,0.506172839506173
"1393",21,93,610,749,1359,0.448859455481972
"1394",21,94,166,170,336,0.494047619047619
"1395",21,95,133,133,266,0.5
"1396",21,96,128,120,248,0.516129032258065
"1397",21,97,154,187,341,0.451612903225806
"1398",21,98,181,192,373,0.485254691689008
"1399",21,99,256,306,562,0.455516014234875
"1400",22,100,166,156,322,0.515527950310559
"1401",22,101,46,44,90,0.511111111111111
"1402",22,102,72,26,98,0.73469387755102
"1403",22,103,16,9,25,0.64
"1404",22,104,192,140,332,0.578313253012048
"1405",22,105,25,27,52,0.480769230769231
"1406",22,106,95,96,191,0.49738219895288
"1407",22,107,42,39,81,0.518518518518518
"1408",22,109,29,16,45,0.644444444444444
"1409",22,110,46,34,80,0.575
"1410",22,111,24,9,33,0.727272727272727
"1411",22,112,135,89,224,0.602678571428571
"1412",22,23,36,37,73,0.493150684931507
"1413",22,25,83,94,177,0.468926553672316
"1414",22,26,121,113,234,0.517094017094017
"1415",22,27,63,56,119,0.529411764705882
"1416",22,28,208,159,367,0.566757493188011
"1417",22,29,55,36,91,0.604395604395604
"1418",22,30,146,101,247,0.591093117408907
"1419",22,31,74,56,130,0.569230769230769
"1420",22,32,117,74,191,0.612565445026178
"1421",22,33,52,41,93,0.559139784946237
"1422",22,34,23,19,42,0.547619047619048
"1423",22,35,67,77,144,0.465277777777778
"1424",22,36,124,67,191,0.649214659685864
"1425",22,37,44,18,62,0.709677419354839
"1426",22,38,23,14,37,0.621621621621622
"1427",22,39,96,101,197,0.487309644670051
"1428",22,40,56,42,98,0.571428571428571
"1429",22,41,62,58,120,0.516666666666667
"1430",22,42,182,95,277,0.657039711191336
"1431",22,43,16,14,30,0.533333333333333
"1432",22,44,153,132,285,0.536842105263158
"1433",22,45,35,25,60,0.583333333333333
"1434",22,46,55,33,88,0.625
"1435",22,47,61,44,105,0.580952380952381
"1436",22,48,42,44,86,0.488372093023256
"1437",22,49,31,17,48,0.645833333333333
"1438",22,50,147,119,266,0.552631578947368
"1439",22,51,81,80,161,0.503105590062112
"1440",22,52,23,16,39,0.58974358974359
"1441",22,53,75,76,151,0.496688741721854
"1442",22,54,47,37,84,0.55952380952381
"1443",22,55,67,47,114,0.587719298245614
"1444",22,56,44,32,76,0.578947368421053
"1445",22,57,112,51,163,0.687116564417178
"1446",22,58,8,12,20,0.4
"1447",22,59,45,63,108,0.416666666666667
"1448",22,60,64,37,101,0.633663366336634
"1449",22,61,23,26,49,0.469387755102041
"1450",22,62,104,88,192,0.541666666666667
"1451",22,63,47,43,90,0.522222222222222
"1452",22,64,45,27,72,0.625
"1453",22,65,17,16,33,0.515151515151515
"1454",22,67,239,136,375,0.637333333333333
"1455",22,68,139,98,237,0.586497890295359
"1456",22,69,159,114,273,0.582417582417582
"1457",22,70,99,51,150,0.66
"1458",22,71,166,108,274,0.605839416058394
"1459",22,72,101,90,191,0.528795811518325
"1460",22,73,151,124,275,0.549090909090909
"1461",22,74,122,102,224,0.544642857142857
"1462",22,75,95,87,182,0.521978021978022
"1463",22,76,27,20,47,0.574468085106383
"1464",22,77,19,14,33,0.575757575757576
"1465",22,78,12,12,24,0.5
"1466",22,79,19,19,38,0.5
"1467",22,80,13,17,30,0.433333333333333
"1468",22,81,62,48,110,0.563636363636364
"1469",22,82,35,24,59,0.593220338983051
"1470",22,83,32,30,62,0.516129032258065
"1471",22,84,89,60,149,0.597315436241611
"1472",22,85,114,80,194,0.587628865979381
"1473",22,86,107,114,221,0.484162895927602
"1474",22,87,78,59,137,0.569343065693431
"1475",22,88,46,43,89,0.51685393258427
"1476",22,89,20,13,33,0.606060606060606
"1477",22,90,44,33,77,0.571428571428571
"1478",22,91,21,16,37,0.567567567567568
"1479",22,92,12,17,29,0.413793103448276
"1480",22,93,167,130,297,0.562289562289562
"1481",22,94,51,42,93,0.548387096774194
"1482",22,95,34,28,62,0.548387096774194
"1483",22,96,46,27,73,0.63013698630137
"1484",22,97,39,42,81,0.481481481481481
"1485",22,98,63,44,107,0.588785046728972
"1486",22,99,93,74,167,0.55688622754491
"1487",23,100,65,76,141,0.460992907801418
"1488",23,101,14,30,44,0.318181818181818
"1489",23,102,34,28,62,0.548387096774194
"1490",23,103,11,12,23,0.478260869565217
"1491",23,104,67,110,177,0.378531073446328
"1492",23,105,4,14,18,0.222222222222222
"1493",23,106,41,54,95,0.431578947368421
"1494",23,107,21,26,47,0.446808510638298
"1495",23,109,14,20,34,0.411764705882353
"1496",23,110,19,27,46,0.41304347826087
"1497",23,111,5,10,15,0.333333333333333
"1498",23,112,64,67,131,0.488549618320611
"1499",23,25,61,92,153,0.398692810457516
"1500",23,26,61,83,144,0.423611111111111
"1501",23,27,34,34,68,0.5
"1502",23,28,73,72,145,0.503448275862069
"1503",23,29,26,25,51,0.509803921568627
"1504",23,30,66,80,146,0.452054794520548
"1505",23,31,39,45,84,0.464285714285714
"1506",23,32,36,42,78,0.461538461538462
"1507",23,33,26,32,58,0.448275862068966
"1508",23,34,16,17,33,0.484848484848485
"1509",23,35,33,36,69,0.478260869565217
"1510",23,36,61,48,109,0.559633027522936
"1511",23,37,19,22,41,0.463414634146341
"1512",23,38,5,16,21,0.238095238095238
"1513",23,39,72,111,183,0.39344262295082
"1514",23,40,32,37,69,0.463768115942029
"1515",23,41,27,42,69,0.391304347826087
"1516",23,42,70,44,114,0.614035087719298
"1517",23,43,17,25,42,0.404761904761905
"1518",23,44,51,86,137,0.372262773722628
"1519",23,45,22,19,41,0.536585365853659
"1520",23,46,49,55,104,0.471153846153846
"1521",23,47,20,20,40,0.5
"1522",23,48,11,21,32,0.34375
"1523",23,49,15,17,32,0.46875
"1524",23,50,67,77,144,0.465277777777778
"1525",23,51,32,37,69,0.463768115942029
"1526",23,52,12,13,25,0.48
"1527",23,53,26,37,63,0.412698412698413
"1528",23,54,25,29,54,0.462962962962963
"1529",23,55,39,43,82,0.475609756097561
"1530",23,56,15,27,42,0.357142857142857
"1531",23,57,52,37,89,0.584269662921348
"1532",23,58,12,8,20,0.6
"1533",23,59,27,29,56,0.482142857142857
"1534",23,60,19,22,41,0.463414634146341
"1535",23,61,8,17,25,0.32
"1536",23,62,50,55,105,0.476190476190476
"1537",23,63,25,31,56,0.446428571428571
"1538",23,64,21,30,51,0.411764705882353
"1539",23,67,68,58,126,0.53968253968254
"1540",23,68,43,65,108,0.398148148148148
"1541",23,69,64,79,143,0.447552447552448
"1542",23,70,41,32,73,0.561643835616438
"1543",23,71,50,61,111,0.45045045045045
"1544",23,72,54,58,112,0.482142857142857
"1545",23,73,78,76,154,0.506493506493506
"1546",23,74,78,113,191,0.408376963350785
"1547",23,75,76,59,135,0.562962962962963
"1548",23,76,9,18,27,0.333333333333333
"1549",23,78,7,9,16,0.4375
"1550",23,79,24,18,42,0.571428571428571
"1551",23,80,7,9,16,0.4375
"1552",23,81,19,26,45,0.422222222222222
"1553",23,82,18,18,36,0.5
"1554",23,83,17,22,39,0.435897435897436
"1555",23,84,41,31,72,0.569444444444444
"1556",23,85,44,50,94,0.468085106382979
"1557",23,86,69,98,167,0.413173652694611
"1558",23,87,33,50,83,0.397590361445783
"1559",23,88,22,21,43,0.511627906976744
"1560",23,89,6,17,23,0.260869565217391
"1561",23,90,14,21,35,0.4
"1562",23,91,12,14,26,0.461538461538462
"1563",23,92,7,6,13,0.538461538461538
"1564",23,93,81,80,161,0.503105590062112
"1565",23,94,16,25,41,0.390243902439024
"1566",23,95,9,25,34,0.264705882352941
"1567",23,96,15,17,32,0.46875
"1568",23,97,35,36,71,0.492957746478873
"1569",23,98,21,28,49,0.428571428571429
"1570",23,99,28,43,71,0.394366197183099
"1571",25,100,294,387,681,0.431718061674009
"1572",25,101,50,93,143,0.34965034965035
"1573",25,102,105,97,202,0.51980198019802
"1574",25,103,17,33,50,0.34
"1575",25,104,230,347,577,0.398613518197574
"1576",25,105,19,40,59,0.322033898305085
"1577",25,106,164,247,411,0.399026763990268
"1578",25,107,94,94,188,0.5
"1579",25,109,53,63,116,0.456896551724138
"1580",25,110,61,97,158,0.386075949367089
"1581",25,111,17,37,54,0.314814814814815
"1582",25,112,163,235,398,0.409547738693467
"1583",25,26,149,234,383,0.389033942558747
"1584",25,27,77,84,161,0.478260869565217
"1585",25,28,358,398,756,0.473544973544974
"1586",25,29,63,76,139,0.453237410071942
"1587",25,30,168,208,376,0.446808510638298
"1588",25,31,101,120,221,0.457013574660633
"1589",25,32,128,132,260,0.492307692307692
"1590",25,33,74,74,148,0.5
"1591",25,34,48,68,116,0.413793103448276
"1592",25,35,59,111,170,0.347058823529412
"1593",25,36,147,173,320,0.459375
"1594",25,37,49,52,101,0.485148514851485
"1595",25,38,28,44,72,0.388888888888889
"1596",25,39,163,294,457,0.356673960612691
"1597",25,40,73,85,158,0.462025316455696
"1598",25,41,75,142,217,0.345622119815668
"1599",25,42,280,254,534,0.524344569288389
"1600",25,43,25,42,67,0.373134328358209
"1601",25,44,197,273,470,0.419148936170213
"1602",25,45,24,49,73,0.328767123287671
"1603",25,46,104,133,237,0.438818565400844
"1604",25,47,81,112,193,0.419689119170984
"1605",25,48,71,71,142,0.5
"1606",25,49,48,60,108,0.444444444444444
"1607",25,50,202,243,445,0.453932584269663
"1608",25,51,111,165,276,0.402173913043478
"1609",25,52,19,29,48,0.395833333333333
"1610",25,53,52,121,173,0.300578034682081
"1611",25,54,66,116,182,0.362637362637363
"1612",25,55,117,151,268,0.436567164179104
"1613",25,56,64,93,157,0.407643312101911
"1614",25,57,156,135,291,0.536082474226804
"1615",25,58,13,41,54,0.240740740740741
"1616",25,59,89,123,212,0.419811320754717
"1617",25,60,90,98,188,0.478723404255319
"1618",25,61,27,51,78,0.346153846153846
"1619",25,62,169,232,401,0.4214463840399
"1620",25,63,70,102,172,0.406976744186047
"1621",25,64,66,74,140,0.471428571428571
"1622",25,65,18,38,56,0.321428571428571
"1623",25,66,10,21,31,0.32258064516129
"1624",25,67,219,219,438,0.5
"1625",25,68,165,208,373,0.442359249329759
"1626",25,69,249,272,521,0.477927063339731
"1627",25,70,129,149,278,0.464028776978417
"1628",25,71,228,245,473,0.482029598308668
"1629",25,72,148,270,418,0.354066985645933
"1630",25,73,228,295,523,0.435946462715105
"1631",25,74,211,276,487,0.433264887063655
"1632",25,75,164,199,363,0.451790633608815
"1633",25,76,33,61,94,0.351063829787234
"1634",25,77,25,36,61,0.409836065573771
"1635",25,78,21,32,53,0.39622641509434
"1636",25,79,43,73,116,0.370689655172414
"1637",25,80,34,37,71,0.47887323943662
"1638",25,81,80,96,176,0.454545454545455
"1639",25,82,42,59,101,0.415841584158416
"1640",25,83,43,66,109,0.394495412844037
"1641",25,84,108,153,261,0.413793103448276
"1642",25,85,184,165,349,0.527220630372493
"1643",25,86,175,251,426,0.410798122065728
"1644",25,87,107,131,238,0.449579831932773
"1645",25,88,63,90,153,0.411764705882353
"1646",25,89,16,35,51,0.313725490196078
"1647",25,90,39,73,112,0.348214285714286
"1648",25,91,32,53,85,0.376470588235294
"1649",25,92,20,37,57,0.350877192982456
"1650",25,93,218,347,565,0.385840707964602
"1651",25,94,74,84,158,0.468354430379747
"1652",25,95,51,65,116,0.439655172413793
"1653",25,96,52,62,114,0.456140350877193
"1654",25,97,70,103,173,0.404624277456647
"1655",25,98,69,114,183,0.377049180327869
"1656",25,99,123,160,283,0.434628975265018
"1657",26,100,271,287,558,0.485663082437276
"1658",26,101,36,55,91,0.395604395604396
"1659",26,102,78,74,152,0.513157894736842
"1660",26,103,19,18,37,0.513513513513513
"1661",26,104,212,286,498,0.42570281124498
"1662",26,105,15,33,48,0.3125
"1663",26,106,212,260,472,0.449152542372881
"1664",26,107,76,70,146,0.520547945205479
"1665",26,109,54,49,103,0.524271844660194
"1666",26,110,78,89,167,0.467065868263473
"1667",26,111,15,21,36,0.416666666666667
"1668",26,112,107,120,227,0.47136563876652
"1669",26,27,45,38,83,0.542168674698795
"1670",26,28,351,300,651,0.539170506912442
"1671",26,29,73,58,131,0.557251908396947
"1672",26,30,96,85,181,0.530386740331492
"1673",26,31,86,90,176,0.488636363636364
"1674",26,32,124,106,230,0.539130434782609
"1675",26,33,33,59,92,0.358695652173913
"1676",26,34,68,103,171,0.39766081871345
"1677",26,35,90,111,201,0.447761194029851
"1678",26,36,140,126,266,0.526315789473684
"1679",26,37,32,32,64,0.5
"1680",26,38,42,28,70,0.6
"1681",26,39,258,376,634,0.406940063091483
"1682",26,40,56,55,111,0.504504504504504
"1683",26,41,84,115,199,0.422110552763819
"1684",26,42,235,205,440,0.534090909090909
"1685",26,43,28,55,83,0.337349397590361
"1686",26,44,184,260,444,0.414414414414414
"1687",26,45,35,34,69,0.507246376811594
"1688",26,46,181,198,379,0.477572559366755
"1689",26,47,91,109,200,0.455
"1690",26,48,65,79,144,0.451388888888889
"1691",26,49,50,78,128,0.390625
"1692",26,50,114,139,253,0.450592885375494
"1693",26,51,142,121,263,0.539923954372624
"1694",26,52,24,37,61,0.39344262295082
"1695",26,53,49,103,152,0.322368421052632
"1696",26,54,47,94,141,0.333333333333333
"1697",26,55,96,122,218,0.440366972477064
"1698",26,56,50,78,128,0.390625
"1699",26,57,111,89,200,0.555
"1700",26,58,19,31,50,0.38
"1701",26,59,91,107,198,0.45959595959596
"1702",26,60,87,80,167,0.520958083832335
"1703",26,61,35,45,80,0.4375
"1704",26,62,148,155,303,0.488448844884488
"1705",26,63,61,80,141,0.432624113475177
"1706",26,64,28,42,70,0.4
"1707",26,65,21,30,51,0.411764705882353
"1708",26,66,11,18,29,0.379310344827586
"1709",26,67,246,185,431,0.5707656612529
"1710",26,68,106,120,226,0.469026548672566
"1711",26,69,223,258,481,0.463617463617464
"1712",26,70,143,134,277,0.516245487364621
"1713",26,71,179,184,363,0.493112947658402
"1714",26,72,167,222,389,0.429305912596401
"1715",26,73,305,302,607,0.502471169686985
"1716",26,74,317,355,672,0.47172619047619
"1717",26,75,152,140,292,0.520547945205479
"1718",26,76,48,38,86,0.558139534883721
"1719",26,77,34,29,63,0.53968253968254
"1720",26,78,25,29,54,0.462962962962963
"1721",26,79,13,16,29,0.448275862068966
"1722",26,80,23,32,55,0.418181818181818
"1723",26,81,49,73,122,0.401639344262295
"1724",26,82,41,59,100,0.41
"1725",26,83,25,36,61,0.409836065573771
"1726",26,84,74,84,158,0.468354430379747
"1727",26,85,164,125,289,0.567474048442907
"1728",26,86,96,133,229,0.419213973799127
"1729",26,87,60,59,119,0.504201680672269
"1730",26,88,52,79,131,0.396946564885496
"1731",26,89,21,31,52,0.403846153846154
"1732",26,90,22,39,61,0.360655737704918
"1733",26,91,34,41,75,0.453333333333333
"1734",26,92,17,17,34,0.5
"1735",26,93,250,284,534,0.468164794007491
"1736",26,94,73,74,147,0.496598639455782
"1737",26,95,51,57,108,0.472222222222222
"1738",26,96,52,52,104,0.5
"1739",26,97,82,131,213,0.384976525821596
"1740",26,98,75,123,198,0.378787878787879
"1741",26,99,120,140,260,0.461538461538462
"1742",27,100,165,121,286,0.576923076923077
"1743",27,101,25,26,51,0.490196078431373
"1744",27,102,59,35,94,0.627659574468085
"1745",27,103,11,10,21,0.523809523809524
"1746",27,104,101,125,226,0.446902654867257
"1747",27,105,9,14,23,0.391304347826087
"1748",27,106,119,103,222,0.536036036036036
"1749",27,107,33,18,51,0.647058823529412
"1750",27,109,21,35,56,0.375
"1751",27,110,54,34,88,0.613636363636364
"1752",27,111,8,7,15,0.533333333333333
"1753",27,112,63,46,109,0.577981651376147
"1754",27,28,186,113,299,0.622073578595318
"1755",27,29,31,39,70,0.442857142857143
"1756",27,30,60,49,109,0.55045871559633
"1757",27,31,34,21,55,0.618181818181818
"1758",27,32,69,38,107,0.644859813084112
"1759",27,33,21,17,38,0.552631578947368
"1760",27,34,28,31,59,0.474576271186441
"1761",27,35,51,47,98,0.520408163265306
"1762",27,36,100,52,152,0.657894736842105
"1763",27,37,19,14,33,0.575757575757576
"1764",27,38,15,17,32,0.46875
"1765",27,39,112,151,263,0.425855513307985
"1766",27,40,22,29,51,0.431372549019608
"1767",27,41,35,52,87,0.402298850574713
"1768",27,42,136,84,220,0.618181818181818
"1769",27,43,40,38,78,0.512820512820513
"1770",27,44,100,102,202,0.495049504950495
"1771",27,45,19,15,34,0.558823529411765
"1772",27,46,86,74,160,0.5375
"1773",27,47,58,61,119,0.487394957983193
"1774",27,48,44,34,78,0.564102564102564
"1775",27,49,30,32,62,0.483870967741935
"1776",27,50,57,53,110,0.518181818181818
"1777",27,51,46,66,112,0.410714285714286
"1778",27,52,14,16,30,0.466666666666667
"1779",27,53,35,46,81,0.432098765432099
"1780",27,54,34,35,69,0.492753623188406
"1781",27,55,53,40,93,0.56989247311828
"1782",27,56,38,33,71,0.535211267605634
"1783",27,57,63,30,93,0.67741935483871
"1784",27,58,9,8,17,0.529411764705882
"1785",27,59,49,50,99,0.494949494949495
"1786",27,60,45,39,84,0.535714285714286
"1787",27,61,24,18,42,0.571428571428571
"1788",27,62,70,69,139,0.503597122302158
"1789",27,63,37,52,89,0.415730337078652
"1790",27,64,30,21,51,0.588235294117647
"1791",27,65,15,11,26,0.576923076923077
"1792",27,67,115,86,201,0.572139303482587
"1793",27,68,52,44,96,0.541666666666667
"1794",27,69,104,65,169,0.615384615384615
"1795",27,70,122,82,204,0.598039215686274
"1796",27,71,116,84,200,0.58
"1797",27,72,118,102,220,0.536363636363636
"1798",27,73,156,132,288,0.541666666666667
"1799",27,74,168,177,345,0.48695652173913
"1800",27,75,74,54,128,0.578125
"1801",27,76,23,20,43,0.534883720930233
"1802",27,77,26,12,38,0.684210526315789
"1803",27,78,13,17,30,0.433333333333333
"1804",27,79,8,16,24,0.333333333333333
"1805",27,80,18,5,23,0.782608695652174
"1806",27,81,29,29,58,0.5
"1807",27,82,20,22,42,0.476190476190476
"1808",27,83,21,22,43,0.488372093023256
"1809",27,84,40,36,76,0.526315789473684
"1810",27,85,79,67,146,0.541095890410959
"1811",27,86,50,52,102,0.490196078431373
"1812",27,87,35,28,63,0.555555555555556
"1813",27,88,28,32,60,0.466666666666667
"1814",27,89,16,15,31,0.516129032258065
"1815",27,90,19,17,36,0.527777777777778
"1816",27,91,13,8,21,0.619047619047619
"1817",27,92,14,14,28,0.5
"1818",27,93,129,122,251,0.51394422310757
"1819",27,94,39,28,67,0.582089552238806
"1820",27,95,27,26,53,0.509433962264151
"1821",27,96,49,20,69,0.710144927536232
"1822",27,97,52,37,89,0.584269662921348
"1823",27,98,41,38,79,0.518987341772152
"1824",27,99,69,55,124,0.556451612903226
"1825",28,100,496,380,876,0.5662100456621
"1826",28,101,135,141,276,0.489130434782609
"1827",28,102,146,92,238,0.613445378151261
"1828",28,103,27,19,46,0.58695652173913
"1829",28,104,287,246,533,0.538461538461538
"1830",28,105,29,34,63,0.46031746031746
"1831",28,106,387,307,694,0.557636887608069
"1832",28,107,156,97,253,0.616600790513834
"1833",28,109,61,42,103,0.592233009708738
"1834",28,110,83,73,156,0.532051282051282
"1835",28,111,56,37,93,0.602150537634409
"1836",28,112,446,354,800,0.5575
"1837",28,29,55,33,88,0.625
"1838",28,30,383,280,663,0.577677224736048
"1839",28,31,331,174,505,0.655445544554455
"1840",28,32,178,108,286,0.622377622377622
"1841",28,33,114,91,205,0.55609756097561
"1842",28,34,99,121,220,0.45
"1843",28,35,116,128,244,0.475409836065574
"1844",28,36,255,149,404,0.631188118811881
"1845",28,37,89,53,142,0.626760563380282
"1846",28,38,33,18,51,0.647058823529412
"1847",28,39,495,470,965,0.512953367875648
"1848",28,40,121,116,237,0.510548523206751
"1849",28,41,79,92,171,0.461988304093567
"1850",28,42,346,196,542,0.638376383763838
"1851",28,43,72,50,122,0.590163934426229
"1852",28,44,277,221,498,0.556224899598394
"1853",28,45,53,40,93,0.56989247311828
"1854",28,46,384,258,642,0.598130841121495
"1855",28,47,141,122,263,0.536121673003802
"1856",28,48,88,77,165,0.533333333333333
"1857",28,49,44,46,90,0.488888888888889
"1858",28,50,615,421,1036,0.593629343629344
"1859",28,51,85,80,165,0.515151515151515
"1860",28,52,56,42,98,0.571428571428571
"1861",28,53,104,101,205,0.507317073170732
"1862",28,54,75,74,149,0.503355704697987
"1863",28,55,127,98,225,0.564444444444444
"1864",28,56,119,108,227,0.524229074889868
"1865",28,57,275,167,442,0.622171945701357
"1866",28,58,23,29,52,0.442307692307692
"1867",28,59,174,133,307,0.566775244299674
"1868",28,60,99,93,192,0.515625
"1869",28,61,22,51,73,0.301369863013699
"1870",28,62,339,250,589,0.575551782682513
"1871",28,63,81,76,157,0.515923566878981
"1872",28,64,143,88,231,0.619047619047619
"1873",28,65,34,30,64,0.53125
"1874",28,66,34,23,57,0.596491228070175
"1875",28,67,277,165,442,0.626696832579186
"1876",28,68,400,293,693,0.577200577200577
"1877",28,69,239,180,419,0.570405727923628
"1878",28,70,172,101,273,0.63003663003663
"1879",28,71,273,205,478,0.571129707112971
"1880",28,72,317,262,579,0.547495682210708
"1881",28,73,532,326,858,0.62004662004662
"1882",28,74,535,409,944,0.566737288135593
"1883",28,75,393,280,673,0.583952451708767
"1884",28,76,51,40,91,0.56043956043956
"1885",28,77,36,22,58,0.620689655172414
"1886",28,78,22,22,44,0.5
"1887",28,79,56,92,148,0.378378378378378
"1888",28,80,26,31,57,0.456140350877193
"1889",28,81,74,62,136,0.544117647058823
"1890",28,82,73,61,134,0.544776119402985
"1891",28,83,78,49,127,0.614173228346457
"1892",28,84,180,157,337,0.534124629080119
"1893",28,85,263,162,425,0.618823529411765
"1894",28,86,408,370,778,0.524421593830334
"1895",28,87,249,180,429,0.58041958041958
"1896",28,88,80,78,158,0.506329113924051
"1897",28,89,36,46,82,0.439024390243902
"1898",28,90,86,89,175,0.491428571428571
"1899",28,91,99,80,179,0.553072625698324
"1900",28,92,61,31,92,0.66304347826087
"1901",28,93,332,292,624,0.532051282051282
"1902",28,94,110,73,183,0.601092896174863
"1903",28,95,75,56,131,0.572519083969466
"1904",28,96,46,29,75,0.613333333333333
"1905",28,97,75,76,151,0.496688741721854
"1906",28,98,70,49,119,0.588235294117647
"1907",28,99,104,68,172,0.604651162790698
"1908",29,100,62,49,111,0.558558558558559
"1909",29,101,30,34,64,0.46875
"1910",29,102,19,21,40,0.475
"1911",29,103,3,3,6,0.5
"1912",29,104,75,65,140,0.535714285714286
"1913",29,105,6,6,12,0.5
"1914",29,106,67,74,141,0.475177304964539
"1915",29,107,12,16,28,0.428571428571429
"1916",29,109,14,10,24,0.583333333333333
"1917",29,110,20,14,34,0.588235294117647
"1918",29,111,12,15,27,0.444444444444444
"1919",29,112,64,76,140,0.457142857142857
"1920",29,30,63,82,145,0.43448275862069
"1921",29,31,37,23,60,0.616666666666667
"1922",29,32,35,35,70,0.5
"1923",29,33,25,25,50,0.5
"1924",29,34,17,36,53,0.320754716981132
"1925",29,35,33,51,84,0.392857142857143
"1926",29,36,44,41,85,0.517647058823529
"1927",29,37,20,25,45,0.444444444444444
"1928",29,38,5,8,13,0.384615384615385
"1929",29,39,79,95,174,0.454022988505747
"1930",29,40,27,22,49,0.551020408163265
"1931",29,41,29,42,71,0.408450704225352
"1932",29,42,56,57,113,0.495575221238938
"1933",29,43,12,8,20,0.6
"1934",29,44,65,74,139,0.467625899280576
"1935",29,45,10,18,28,0.357142857142857
"1936",29,46,65,63,128,0.5078125
"1937",29,47,27,44,71,0.380281690140845
"1938",29,48,31,25,56,0.553571428571429
"1939",29,49,16,8,24,0.666666666666667
"1940",29,50,89,68,157,0.56687898089172
"1941",29,51,15,14,29,0.517241379310345
"1942",29,52,12,15,27,0.444444444444444
"1943",29,53,24,25,49,0.489795918367347
"1944",29,54,27,41,68,0.397058823529412
"1945",29,55,18,15,33,0.545454545454545
"1946",29,56,26,14,40,0.65
"1947",29,57,49,29,78,0.628205128205128
"1948",29,58,6,11,17,0.352941176470588
"1949",29,59,25,31,56,0.446428571428571
"1950",29,60,25,10,35,0.714285714285714
"1951",29,61,3,8,11,0.272727272727273
"1952",29,62,45,53,98,0.459183673469388
"1953",29,63,31,29,60,0.516666666666667
"1954",29,64,27,22,49,0.551020408163265
"1955",29,65,2,5,7,0.285714285714286
"1956",29,67,94,52,146,0.643835616438356
"1957",29,68,50,63,113,0.442477876106195
"1958",29,69,40,47,87,0.459770114942529
"1959",29,70,43,35,78,0.551282051282051
"1960",29,71,36,30,66,0.545454545454545
"1961",29,72,63,83,146,0.431506849315068
"1962",29,73,85,82,167,0.508982035928144
"1963",29,74,110,123,233,0.472103004291845
"1964",29,75,64,67,131,0.488549618320611
"1965",29,76,7,17,24,0.291666666666667
"1966",29,77,10,15,25,0.4
"1967",29,78,4,7,11,0.363636363636364
"1968",29,79,15,11,26,0.576923076923077
"1969",29,80,3,12,15,0.2
"1970",29,81,22,24,46,0.478260869565217
"1971",29,82,15,13,28,0.535714285714286
"1972",29,83,13,17,30,0.433333333333333
"1973",29,84,39,26,65,0.6
"1974",29,85,33,30,63,0.523809523809524
"1975",29,86,62,76,138,0.449275362318841
"1976",29,87,51,49,100,0.51
"1977",29,88,15,17,32,0.46875
"1978",29,89,8,10,18,0.444444444444444
"1979",29,90,20,14,34,0.588235294117647
"1980",29,91,13,20,33,0.393939393939394
"1981",29,92,9,17,26,0.346153846153846
"1982",29,93,70,80,150,0.466666666666667
"1983",29,94,23,20,43,0.534883720930233
"1984",29,95,19,16,35,0.542857142857143
"1985",29,96,5,7,12,0.416666666666667
"1986",29,97,17,27,44,0.386363636363636
"1987",29,98,17,11,28,0.607142857142857
"1988",29,99,17,19,36,0.472222222222222
"1989",3,10,10,14,24,0.416666666666667
"1990",3,100,87,90,177,0.491525423728814
"1991",3,101,17,13,30,0.566666666666667
"1992",3,102,25,18,43,0.581395348837209
"1993",3,103,4,3,7,0.571428571428571
"1994",3,104,64,94,158,0.40506329113924
"1995",3,105,3,7,10,0.3
"1996",3,106,76,105,181,0.419889502762431
"1997",3,107,17,24,41,0.414634146341463
"1998",3,109,14,15,29,0.482758620689655
"1999",3,11,189,158,347,0.544668587896254
"2000",3,110,41,28,69,0.594202898550725
"2001",3,111,5,7,12,0.416666666666667
"2002",3,112,23,46,69,0.333333333333333
"2003",3,12,43,39,82,0.524390243902439
"2004",3,13,18,20,38,0.473684210526316
"2005",3,14,80,96,176,0.454545454545455
"2006",3,15,27,34,61,0.442622950819672
"2007",3,16,21,27,48,0.4375
"2008",3,17,15,31,46,0.326086956521739
"2009",3,18,20,36,56,0.357142857142857
"2010",3,19,54,63,117,0.461538461538462
"2011",3,20,20,23,43,0.465116279069767
"2012",3,21,159,227,386,0.411917098445596
"2013",3,22,48,36,84,0.571428571428571
"2014",3,23,22,29,51,0.431372549019608
"2015",3,25,49,78,127,0.385826771653543
"2016",3,26,35,35,70,0.5
"2017",3,27,22,15,37,0.594594594594595
"2018",3,28,130,117,247,0.526315789473684
"2019",3,29,29,32,61,0.475409836065574
"2020",3,30,43,28,71,0.605633802816901
"2021",3,31,33,34,67,0.492537313432836
"2022",3,32,28,27,55,0.509090909090909
"2023",3,33,11,20,31,0.354838709677419
"2024",3,34,19,32,51,0.372549019607843
"2025",3,35,17,31,48,0.354166666666667
"2026",3,36,48,53,101,0.475247524752475
"2027",3,37,10,15,25,0.4
"2028",3,38,13,20,33,0.393939393939394
"2029",3,39,97,113,210,0.461904761904762
"2030",3,4,19,21,40,0.475
"2031",3,40,15,16,31,0.483870967741935
"2032",3,41,28,33,61,0.459016393442623
"2033",3,42,75,80,155,0.483870967741935
"2034",3,43,15,14,29,0.517241379310345
"2035",3,44,63,90,153,0.411764705882353
"2036",3,45,4,11,15,0.266666666666667
"2037",3,46,63,64,127,0.496062992125984
"2038",3,47,36,44,80,0.45
"2039",3,48,29,17,46,0.630434782608696
"2040",3,49,17,25,42,0.404761904761905
"2041",3,5,30,35,65,0.461538461538462
"2042",3,50,29,47,76,0.381578947368421
"2043",3,51,41,62,103,0.398058252427184
"2044",3,52,10,12,22,0.454545454545455
"2045",3,53,17,24,41,0.414634146341463
"2046",3,54,20,23,43,0.465116279069767
"2047",3,55,43,36,79,0.544303797468354
"2048",3,56,21,26,47,0.446808510638298
"2049",3,57,45,27,72,0.625
"2050",3,58,4,8,12,0.333333333333333
"2051",3,59,30,40,70,0.428571428571429
"2052",3,6,14,24,38,0.368421052631579
"2053",3,60,31,36,67,0.462686567164179
"2054",3,61,16,14,30,0.533333333333333
"2055",3,62,35,70,105,0.333333333333333
"2056",3,63,22,30,52,0.423076923076923
"2057",3,64,14,25,39,0.358974358974359
"2058",3,65,7,11,18,0.388888888888889
"2059",3,66,7,5,12,0.583333333333333
"2060",3,67,82,61,143,0.573426573426573
"2061",3,68,41,48,89,0.460674157303371
"2062",3,69,67,74,141,0.475177304964539
"2063",3,7,94,97,191,0.492146596858639
"2064",3,70,44,38,82,0.536585365853659
"2065",3,71,52,51,103,0.504854368932039
"2066",3,72,90,97,187,0.481283422459893
"2067",3,73,95,100,195,0.487179487179487
"2068",3,74,97,137,234,0.414529914529915
"2069",3,75,53,49,102,0.519607843137255
"2070",3,76,18,12,30,0.6
"2071",3,77,9,9,18,0.5
"2072",3,78,15,12,27,0.555555555555556
"2073",3,79,6,10,16,0.375
"2074",3,8,134,121,255,0.525490196078431
"2075",3,80,6,8,14,0.428571428571429
"2076",3,81,20,18,38,0.526315789473684
"2077",3,82,22,16,38,0.578947368421053
"2078",3,83,8,8,16,0.5
"2079",3,84,21,21,42,0.5
"2080",3,85,41,42,83,0.493975903614458
"2081",3,86,38,49,87,0.436781609195402
"2082",3,87,21,20,41,0.51219512195122
"2083",3,88,19,32,51,0.372549019607843
"2084",3,9,126,137,263,0.479087452471483
"2085",3,90,11,12,23,0.478260869565217
"2086",3,91,8,10,18,0.444444444444444
"2087",3,93,93,96,189,0.492063492063492
"2088",3,94,21,22,43,0.488372093023256
"2089",3,95,14,17,31,0.451612903225806
"2090",3,96,19,24,43,0.441860465116279
"2091",3,97,32,34,66,0.484848484848485
"2092",3,98,29,34,63,0.46031746031746
"2093",3,99,38,39,77,0.493506493506494
"2094",30,100,291,248,539,0.539888682745826
"2095",30,101,36,51,87,0.413793103448276
"2096",30,102,84,62,146,0.575342465753425
"2097",30,103,23,24,47,0.48936170212766
"2098",30,104,251,255,506,0.49604743083004
"2099",30,105,15,25,40,0.375
"2100",30,106,239,238,477,0.50104821802935
"2101",30,107,72,61,133,0.541353383458647
"2102",30,109,40,39,79,0.506329113924051
"2103",30,110,113,74,187,0.60427807486631
"2104",30,111,16,11,27,0.592592592592593
"2105",30,112,113,103,216,0.523148148148148
"2106",30,31,102,71,173,0.589595375722543
"2107",30,32,117,98,215,0.544186046511628
"2108",30,33,62,66,128,0.484375
"2109",30,34,63,58,121,0.520661157024793
"2110",30,35,92,104,196,0.469387755102041
"2111",30,36,199,124,323,0.61609907120743
"2112",30,37,40,30,70,0.571428571428571
"2113",30,38,36,30,66,0.545454545454545
"2114",30,39,278,349,627,0.443381180223285
"2115",30,40,70,55,125,0.56
"2116",30,41,158,196,354,0.446327683615819
"2117",30,42,293,203,496,0.590725806451613
"2118",30,43,53,51,104,0.509615384615385
"2119",30,44,233,239,472,0.49364406779661
"2120",30,45,28,22,50,0.56
"2121",30,46,174,193,367,0.474114441416894
"2122",30,47,133,120,253,0.525691699604743
"2123",30,48,88,69,157,0.560509554140127
"2124",30,49,56,58,114,0.491228070175439
"2125",30,50,124,103,227,0.54625550660793
"2126",30,51,137,155,292,0.469178082191781
"2127",30,52,21,31,52,0.403846153846154
"2128",30,53,69,93,162,0.425925925925926
"2129",30,54,81,74,155,0.52258064516129
"2130",30,55,116,118,234,0.495726495726496
"2131",30,56,64,93,157,0.407643312101911
"2132",30,57,124,70,194,0.639175257731959
"2133",30,58,13,20,33,0.393939393939394
"2134",30,59,96,96,192,0.5
"2135",30,60,88,85,173,0.508670520231214
"2136",30,61,41,45,86,0.476744186046512
"2137",30,62,144,142,286,0.503496503496504
"2138",30,63,63,63,126,0.5
"2139",30,64,53,48,101,0.524752475247525
"2140",30,65,19,20,39,0.487179487179487
"2141",30,66,4,10,14,0.285714285714286
"2142",30,67,252,168,420,0.6
"2143",30,68,119,101,220,0.540909090909091
"2144",30,69,248,193,441,0.562358276643991
"2145",30,70,127,81,208,0.610576923076923
"2146",30,71,210,164,374,0.561497326203209
"2147",30,72,212,207,419,0.505966587112172
"2148",30,73,320,292,612,0.522875816993464
"2149",30,74,293,297,590,0.496610169491525
"2150",30,75,154,120,274,0.562043795620438
"2151",30,76,45,48,93,0.483870967741935
"2152",30,77,35,21,56,0.625
"2153",30,78,30,22,52,0.576923076923077
"2154",30,79,14,28,42,0.333333333333333
"2155",30,80,23,20,43,0.534883720930233
"2156",30,81,75,79,154,0.487012987012987
"2157",30,82,44,44,88,0.5
"2158",30,83,34,38,72,0.472222222222222
"2159",30,84,87,63,150,0.58
"2160",30,85,195,131,326,0.598159509202454
"2161",30,86,104,114,218,0.477064220183486
"2162",30,87,68,73,141,0.482269503546099
"2163",30,88,84,73,157,0.535031847133758
"2164",30,89,17,33,50,0.34
"2165",30,90,28,27,55,0.509090909090909
"2166",30,91,21,34,55,0.381818181818182
"2167",30,92,15,26,41,0.365853658536585
"2168",30,93,258,233,491,0.525458248472505
"2169",30,94,79,57,136,0.580882352941177
"2170",30,95,52,54,106,0.490566037735849
"2171",30,96,68,54,122,0.557377049180328
"2172",30,97,102,138,240,0.425
"2173",30,98,85,101,186,0.456989247311828
"2174",30,99,143,128,271,0.527675276752767
"2175",31,100,199,143,342,0.58187134502924
"2176",31,101,36,38,74,0.486486486486487
"2177",31,102,60,35,95,0.631578947368421
"2178",31,103,11,8,19,0.578947368421053
"2179",31,104,142,137,279,0.508960573476703
"2180",31,105,9,17,26,0.346153846153846
"2181",31,106,168,136,304,0.552631578947368
"2182",31,107,51,38,89,0.573033707865168
"2183",31,109,33,21,54,0.611111111111111
"2184",31,110,41,37,78,0.525641025641026
"2185",31,111,9,6,15,0.6
"2186",31,112,111,84,195,0.569230769230769
"2187",31,32,77,44,121,0.636363636363636
"2188",31,33,38,38,76,0.5
"2189",31,34,36,50,86,0.418604651162791
"2190",31,35,66,57,123,0.536585365853659
"2191",31,36,96,53,149,0.644295302013423
"2192",31,37,21,14,35,0.6
"2193",31,38,24,18,42,0.571428571428571
"2194",31,39,203,202,405,0.501234567901235
"2195",31,40,48,31,79,0.607594936708861
"2196",31,41,68,77,145,0.468965517241379
"2197",31,42,251,99,350,0.717142857142857
"2198",31,43,24,19,43,0.558139534883721
"2199",31,44,130,131,261,0.498084291187739
"2200",31,45,11,13,24,0.458333333333333
"2201",31,46,140,84,224,0.625
"2202",31,47,64,58,122,0.524590163934426
"2203",31,48,59,35,94,0.627659574468085
"2204",31,49,33,35,68,0.485294117647059
"2205",31,50,91,70,161,0.565217391304348
"2206",31,51,67,63,130,0.515384615384615
"2207",31,52,29,24,53,0.547169811320755
"2208",31,53,37,38,75,0.493333333333333
"2209",31,54,41,45,86,0.476744186046512
"2210",31,55,60,61,121,0.495867768595041
"2211",31,56,50,37,87,0.574712643678161
"2212",31,57,57,39,96,0.59375
"2213",31,58,14,17,31,0.451612903225806
"2214",31,59,85,47,132,0.643939393939394
"2215",31,60,53,46,99,0.535353535353535
"2216",31,61,29,19,48,0.604166666666667
"2217",31,62,87,79,166,0.524096385542169
"2218",31,63,40,35,75,0.533333333333333
"2219",31,64,30,26,56,0.535714285714286
"2220",31,65,12,16,28,0.428571428571429
"2221",31,66,7,7,14,0.5
"2222",31,67,169,85,254,0.665354330708661
"2223",31,68,91,52,143,0.636363636363636
"2224",31,69,314,187,501,0.626746506986028
"2225",31,70,79,53,132,0.598484848484849
"2226",31,71,142,101,243,0.584362139917695
"2227",31,72,136,130,266,0.511278195488722
"2228",31,73,212,152,364,0.582417582417582
"2229",31,74,225,148,373,0.603217158176944
"2230",31,75,108,75,183,0.590163934426229
"2231",31,76,25,18,43,0.581395348837209
"2232",31,77,15,12,27,0.555555555555556
"2233",31,78,16,20,36,0.444444444444444
"2234",31,79,14,9,23,0.608695652173913
"2235",31,80,17,18,35,0.485714285714286
"2236",31,81,47,39,86,0.546511627906977
"2237",31,82,34,26,60,0.566666666666667
"2238",31,83,19,23,42,0.452380952380952
"2239",31,84,62,40,102,0.607843137254902
"2240",31,85,109,71,180,0.605555555555556
"2241",31,86,84,68,152,0.552631578947368
"2242",31,87,83,42,125,0.664
"2243",31,88,24,30,54,0.444444444444444
"2244",31,89,13,16,29,0.448275862068966
"2245",31,90,13,21,34,0.382352941176471
"2246",31,91,17,20,37,0.459459459459459
"2247",31,92,10,14,24,0.416666666666667
"2248",31,93,159,146,305,0.521311475409836
"2249",31,94,31,32,63,0.492063492063492
"2250",31,95,24,21,45,0.533333333333333
"2251",31,96,24,33,57,0.421052631578947
"2252",31,97,75,94,169,0.443786982248521
"2253",31,98,50,60,110,0.454545454545455
"2254",31,99,64,71,135,0.474074074074074
"2255",32,100,118,135,253,0.466403162055336
"2256",32,101,29,42,71,0.408450704225352
"2257",32,102,56,34,90,0.622222222222222
"2258",32,103,9,11,20,0.45
"2259",32,104,147,127,274,0.536496350364963
"2260",32,105,23,16,39,0.58974358974359
"2261",32,106,116,88,204,0.568627450980392
"2262",32,107,37,32,69,0.536231884057971
"2263",32,109,28,22,50,0.56
"2264",32,110,45,25,70,0.642857142857143
"2265",32,111,18,9,27,0.666666666666667
"2266",32,112,120,82,202,0.594059405940594
"2267",32,33,39,34,73,0.534246575342466
"2268",32,34,53,44,97,0.54639175257732
"2269",32,35,70,58,128,0.546875
"2270",32,36,113,73,186,0.60752688172043
"2271",32,37,33,24,57,0.578947368421053
"2272",32,38,19,14,33,0.575757575757576
"2273",32,39,156,137,293,0.532423208191126
"2274",32,40,56,33,89,0.629213483146067
"2275",32,41,38,46,84,0.452380952380952
"2276",32,42,133,67,200,0.665
"2277",32,43,28,42,70,0.4
"2278",32,44,89,96,185,0.481081081081081
"2279",32,45,24,27,51,0.470588235294118
"2280",32,46,90,69,159,0.566037735849057
"2281",32,47,69,48,117,0.58974358974359
"2282",32,48,38,27,65,0.584615384615385
"2283",32,49,23,28,51,0.450980392156863
"2284",32,50,132,99,231,0.571428571428571
"2285",32,51,39,36,75,0.52
"2286",32,52,19,15,34,0.558823529411765
"2287",32,53,47,57,104,0.451923076923077
"2288",32,54,42,32,74,0.567567567567568
"2289",32,55,78,43,121,0.644628099173554
"2290",32,56,19,17,36,0.527777777777778
"2291",32,57,101,56,157,0.643312101910828
"2292",32,58,10,14,24,0.416666666666667
"2293",32,59,57,60,117,0.487179487179487
"2294",32,60,40,28,68,0.588235294117647
"2295",32,61,9,23,32,0.28125
"2296",32,62,45,54,99,0.454545454545455
"2297",32,63,23,34,57,0.403508771929825
"2298",32,64,58,28,86,0.674418604651163
"2299",32,65,20,14,34,0.588235294117647
"2300",32,66,10,7,17,0.588235294117647
"2301",32,67,83,62,145,0.572413793103448
"2302",32,68,98,80,178,0.550561797752809
"2303",32,69,111,59,170,0.652941176470588
"2304",32,70,77,52,129,0.596899224806202
"2305",32,71,138,88,226,0.610619469026549
"2306",32,72,94,78,172,0.546511627906977
"2307",32,73,177,100,277,0.63898916967509
"2308",32,74,185,175,360,0.513888888888889
"2309",32,75,124,91,215,0.576744186046512
"2310",32,76,32,22,54,0.592592592592593
"2311",32,77,14,12,26,0.538461538461538
"2312",32,78,19,13,32,0.59375
"2313",32,79,21,28,49,0.428571428571429
"2314",32,80,14,21,35,0.4
"2315",32,81,42,27,69,0.608695652173913
"2316",32,82,30,19,49,0.612244897959184
"2317",32,83,27,21,48,0.5625
"2318",32,84,80,58,138,0.579710144927536
"2319",32,85,92,49,141,0.652482269503546
"2320",32,86,104,116,220,0.472727272727273
"2321",32,87,64,52,116,0.551724137931034
"2322",32,88,31,28,59,0.525423728813559
"2323",32,89,9,9,18,0.5
"2324",32,90,36,26,62,0.580645161290323
"2325",32,91,21,24,45,0.466666666666667
"2326",32,92,18,6,24,0.75
"2327",32,93,86,96,182,0.472527472527473
"2328",32,94,41,25,66,0.621212121212121
"2329",32,95,23,21,44,0.522727272727273
"2330",32,96,30,16,46,0.652173913043478
"2331",32,97,40,39,79,0.506329113924051
"2332",32,98,39,39,78,0.5
"2333",32,99,67,58,125,0.536
"2334",33,100,76,76,152,0.5
"2335",33,101,16,19,35,0.457142857142857
"2336",33,102,28,22,50,0.56
"2337",33,103,5,3,8,0.625
"2338",33,104,55,65,120,0.458333333333333
"2339",33,105,5,4,9,0.555555555555556
"2340",33,106,83,86,169,0.49112426035503
"2341",33,107,16,27,43,0.372093023255814
"2342",33,109,20,14,34,0.588235294117647
"2343",33,110,33,29,62,0.532258064516129
"2344",33,111,7,10,17,0.411764705882353
"2345",33,112,41,47,88,0.465909090909091
"2346",33,34,19,22,41,0.463414634146341
"2347",33,35,17,50,67,0.253731343283582
"2348",33,36,62,33,95,0.652631578947368
"2349",33,37,15,7,22,0.681818181818182
"2350",33,38,15,13,28,0.535714285714286
"2351",33,39,103,105,208,0.495192307692308
"2352",33,40,12,25,37,0.324324324324324
"2353",33,41,19,41,60,0.316666666666667
"2354",33,42,56,47,103,0.543689320388349
"2355",33,43,21,16,37,0.567567567567568
"2356",33,44,65,86,151,0.43046357615894
"2357",33,45,8,14,22,0.363636363636364
"2358",33,46,67,72,139,0.482014388489209
"2359",33,47,36,24,60,0.6
"2360",33,48,25,18,43,0.581395348837209
"2361",33,49,15,23,38,0.394736842105263
"2362",33,50,67,59,126,0.531746031746032
"2363",33,51,51,38,89,0.573033707865168
"2364",33,52,12,11,23,0.521739130434783
"2365",33,53,14,12,26,0.538461538461538
"2366",33,54,11,15,26,0.423076923076923
"2367",33,55,56,62,118,0.474576271186441
"2368",33,56,17,30,47,0.361702127659574
"2369",33,57,37,19,56,0.660714285714286
"2370",33,58,8,6,14,0.571428571428571
"2371",33,59,39,26,65,0.6
"2372",33,60,32,16,48,0.666666666666667
"2373",33,61,14,17,31,0.451612903225806
"2374",33,62,35,39,74,0.472972972972973
"2375",33,63,24,19,43,0.558139534883721
"2376",33,64,20,14,34,0.588235294117647
"2377",33,65,14,6,20,0.7
"2378",33,67,78,58,136,0.573529411764706
"2379",33,68,43,36,79,0.544303797468354
"2380",33,69,63,37,100,0.63
"2381",33,70,31,31,62,0.5
"2382",33,71,55,46,101,0.544554455445545
"2383",33,72,74,86,160,0.4625
"2384",33,73,105,90,195,0.538461538461538
"2385",33,74,126,132,258,0.488372093023256
"2386",33,75,69,61,130,0.530769230769231
"2387",33,76,16,22,38,0.421052631578947
"2388",33,77,9,15,24,0.375
"2389",33,78,10,4,14,0.714285714285714
"2390",33,79,11,9,20,0.55
"2391",33,80,4,3,7,0.571428571428571
"2392",33,81,20,27,47,0.425531914893617
"2393",33,82,12,18,30,0.4
"2394",33,83,15,13,28,0.535714285714286
"2395",33,84,28,37,65,0.430769230769231
"2396",33,85,43,41,84,0.511904761904762
"2397",33,86,50,61,111,0.45045045045045
"2398",33,87,34,34,68,0.5
"2399",33,88,15,24,39,0.384615384615385
"2400",33,89,11,14,25,0.44
"2401",33,90,7,15,22,0.318181818181818
"2402",33,91,9,11,20,0.45
"2403",33,92,9,5,14,0.642857142857143
"2404",33,93,92,90,182,0.505494505494505
"2405",33,94,25,22,47,0.531914893617021
"2406",33,95,20,16,36,0.555555555555556
"2407",33,96,24,21,45,0.533333333333333
"2408",33,97,29,70,99,0.292929292929293
"2409",33,98,29,30,59,0.491525423728814
"2410",33,99,47,46,93,0.505376344086022
"2411",34,100,86,104,190,0.452631578947368
"2412",34,101,16,43,59,0.271186440677966
"2413",34,102,39,39,78,0.5
"2414",34,103,5,13,18,0.277777777777778
"2415",34,104,86,127,213,0.403755868544601
"2416",34,105,18,14,32,0.5625
"2417",34,106,30,54,84,0.357142857142857
"2418",34,107,24,27,51,0.470588235294118
"2419",34,109,11,18,29,0.379310344827586
"2420",34,110,27,30,57,0.473684210526316
"2421",34,111,17,13,30,0.566666666666667
"2422",34,112,67,65,132,0.507575757575758
"2423",34,35,19,43,62,0.306451612903226
"2424",34,36,56,47,103,0.543689320388349
"2425",34,37,14,18,32,0.4375
"2426",34,38,12,15,27,0.444444444444444
"2427",34,39,28,54,82,0.341463414634146
"2428",34,40,19,36,55,0.345454545454545
"2429",34,41,22,49,71,0.309859154929577
"2430",34,42,82,78,160,0.5125
"2431",34,43,5,10,15,0.333333333333333
"2432",34,44,69,77,146,0.472602739726027
"2433",34,45,13,24,37,0.351351351351351
"2434",34,46,14,18,32,0.4375
"2435",34,47,18,32,50,0.36
"2436",34,48,17,31,48,0.354166666666667
"2437",34,49,12,24,36,0.333333333333333
"2438",34,50,68,83,151,0.450331125827815
"2439",34,51,36,45,81,0.444444444444444
"2440",34,52,9,10,19,0.473684210526316
"2441",34,53,20,52,72,0.277777777777778
"2442",34,54,32,38,70,0.457142857142857
"2443",34,55,27,33,60,0.45
"2444",34,56,16,31,47,0.340425531914894
"2445",34,57,56,58,114,0.491228070175439
"2446",34,58,8,10,18,0.444444444444444
"2447",34,59,22,46,68,0.323529411764706
"2448",34,60,25,34,59,0.423728813559322
"2449",34,61,10,18,28,0.357142857142857
"2450",34,62,68,103,171,0.39766081871345
"2451",34,63,22,21,43,0.511627906976744
"2452",34,64,22,30,52,0.423076923076923
"2453",34,65,7,14,21,0.333333333333333
"2454",34,66,3,5,8,0.375
"2455",34,67,75,79,154,0.487012987012987
"2456",34,68,44,64,108,0.407407407407407
"2457",34,69,67,83,150,0.446666666666667
"2458",34,70,44,47,91,0.483516483516484
"2459",34,71,76,99,175,0.434285714285714
"2460",34,72,49,71,120,0.408333333333333
"2461",34,73,55,64,119,0.46218487394958
"2462",34,74,30,61,91,0.32967032967033
"2463",34,75,65,73,138,0.471014492753623
"2464",34,76,7,8,15,0.466666666666667
"2465",34,77,13,15,28,0.464285714285714
"2466",34,78,10,6,16,0.625
"2467",34,79,9,17,26,0.346153846153846
"2468",34,80,6,15,21,0.285714285714286
"2469",34,81,16,30,46,0.347826086956522
"2470",34,82,8,21,29,0.275862068965517
"2471",34,83,20,23,43,0.465116279069767
"2472",34,84,43,60,103,0.41747572815534
"2473",34,85,60,57,117,0.512820512820513
"2474",34,86,68,94,162,0.419753086419753
"2475",34,87,54,45,99,0.545454545454545
"2476",34,88,16,20,36,0.444444444444444
"2477",34,89,6,9,15,0.4
"2478",34,90,16,26,42,0.380952380952381
"2479",34,91,9,16,25,0.36
"2480",34,92,6,6,12,0.5
"2481",34,93,93,111,204,0.455882352941176
"2482",34,94,18,10,28,0.642857142857143
"2483",34,95,8,26,34,0.235294117647059
"2484",34,96,18,22,40,0.45
"2485",34,97,19,26,45,0.422222222222222
"2486",34,98,24,32,56,0.428571428571429
"2487",34,99,35,47,82,0.426829268292683
"2488",35,100,104,122,226,0.460176991150442
"2489",35,101,21,47,68,0.308823529411765
"2490",35,102,67,43,110,0.609090909090909
"2491",35,103,17,17,34,0.5
"2492",35,104,119,197,316,0.376582278481013
"2493",35,105,17,22,39,0.435897435897436
"2494",35,106,73,95,168,0.43452380952381
"2495",35,107,18,24,42,0.428571428571429
"2496",35,109,27,18,45,0.6
"2497",35,110,39,32,71,0.549295774647887
"2498",35,111,12,13,25,0.48
"2499",35,112,69,107,176,0.392045454545455
"2500",35,36,99,87,186,0.532258064516129
"2501",35,37,37,38,75,0.493333333333333
"2502",35,38,10,14,24,0.416666666666667
"2503",35,39,64,127,191,0.335078534031414
"2504",35,40,46,52,98,0.469387755102041
"2505",35,41,44,67,111,0.396396396396396
"2506",35,42,100,90,190,0.526315789473684
"2507",35,43,27,25,52,0.519230769230769
"2508",35,44,85,111,196,0.433673469387755
"2509",35,45,22,24,46,0.478260869565217
"2510",35,46,43,60,103,0.41747572815534
"2511",35,47,33,40,73,0.452054794520548
"2512",35,48,30,37,67,0.447761194029851
"2513",35,49,26,30,56,0.464285714285714
"2514",35,50,96,103,199,0.482412060301508
"2515",35,51,49,50,99,0.494949494949495
"2516",35,52,13,20,33,0.393939393939394
"2517",35,53,28,50,78,0.358974358974359
"2518",35,54,37,53,90,0.411111111111111
"2519",35,55,46,54,100,0.46
"2520",35,56,18,33,51,0.352941176470588
"2521",35,57,102,80,182,0.56043956043956
"2522",35,58,9,18,27,0.333333333333333
"2523",35,59,38,65,103,0.368932038834951
"2524",35,60,41,53,94,0.436170212765957
"2525",35,61,15,30,45,0.333333333333333
"2526",35,62,72,106,178,0.404494382022472
"2527",35,63,28,31,59,0.474576271186441
"2528",35,64,37,40,77,0.480519480519481
"2529",35,65,14,15,29,0.482758620689655
"2530",35,66,5,7,12,0.416666666666667
"2531",35,67,63,51,114,0.552631578947368
"2532",35,68,80,109,189,0.423280423280423
"2533",35,69,99,92,191,0.518324607329843
"2534",35,70,76,48,124,0.612903225806452
"2535",35,71,108,114,222,0.486486486486487
"2536",35,72,54,66,120,0.45
"2537",35,73,118,140,258,0.457364341085271
"2538",35,74,107,161,268,0.399253731343284
"2539",35,75,82,97,179,0.458100558659218
"2540",35,76,12,18,30,0.4
"2541",35,77,9,24,33,0.272727272727273
"2542",35,78,10,12,22,0.454545454545455
"2543",35,79,14,18,32,0.4375
"2544",35,80,8,17,25,0.32
"2545",35,81,32,33,65,0.492307692307692
"2546",35,82,17,26,43,0.395348837209302
"2547",35,83,32,35,67,0.477611940298507
"2548",35,84,83,82,165,0.503030303030303
"2549",35,85,89,82,171,0.52046783625731
"2550",35,86,69,102,171,0.403508771929825
"2551",35,87,50,50,100,0.5
"2552",35,88,27,39,66,0.409090909090909
"2553",35,89,4,11,15,0.266666666666667
"2554",35,90,31,43,74,0.418918918918919
"2555",35,91,14,17,31,0.451612903225806
"2556",35,92,5,9,14,0.357142857142857
"2557",35,93,70,78,148,0.472972972972973
"2558",35,94,22,38,60,0.366666666666667
"2559",35,95,24,28,52,0.461538461538462
"2560",35,96,27,33,60,0.45
"2561",35,97,32,50,82,0.390243902439024
"2562",35,98,25,57,82,0.304878048780488
"2563",35,99,76,77,153,0.496732026143791
"2564",36,100,222,165,387,0.573643410852713
"2565",36,101,31,53,84,0.369047619047619
"2566",36,102,110,53,163,0.674846625766871
"2567",36,103,27,13,40,0.675
"2568",36,104,209,198,407,0.513513513513513
"2569",36,105,20,26,46,0.434782608695652
"2570",36,106,178,149,327,0.54434250764526
"2571",36,107,57,49,106,0.537735849056604
"2572",36,109,34,27,61,0.557377049180328
"2573",36,110,63,47,110,0.572727272727273
"2574",36,111,15,28,43,0.348837209302326
"2575",36,112,164,104,268,0.611940298507463
"2576",36,37,45,30,75,0.6
"2577",36,38,31,23,54,0.574074074074074
"2578",36,39,199,175,374,0.532085561497326
"2579",36,40,55,52,107,0.514018691588785
"2580",36,41,82,73,155,0.529032258064516
"2581",36,42,238,146,384,0.619791666666667
"2582",36,43,39,40,79,0.493670886075949
"2583",36,44,204,160,364,0.56043956043956
"2584",36,45,32,20,52,0.615384615384615
"2585",36,46,153,110,263,0.581749049429658
"2586",36,47,86,69,155,0.554838709677419
"2587",36,48,74,38,112,0.660714285714286
"2588",36,49,58,42,100,0.58
"2589",36,50,157,106,263,0.596958174904943
"2590",36,51,58,71,129,0.449612403100775
"2591",36,52,26,23,49,0.530612244897959
"2592",36,53,69,70,139,0.496402877697842
"2593",36,54,65,72,137,0.474452554744526
"2594",36,55,56,55,111,0.504504504504504
"2595",36,56,36,45,81,0.444444444444444
"2596",36,57,140,66,206,0.679611650485437
"2597",36,58,21,14,35,0.6
"2598",36,59,102,83,185,0.551351351351351
"2599",36,60,77,58,135,0.57037037037037
"2600",36,61,26,40,66,0.393939393939394
"2601",36,62,127,122,249,0.51004016064257
"2602",36,63,54,41,95,0.568421052631579
"2603",36,64,62,44,106,0.584905660377358
"2604",36,65,19,16,35,0.542857142857143
"2605",36,66,15,8,23,0.652173913043478
"2606",36,67,217,105,322,0.673913043478261
"2607",36,68,147,109,256,0.57421875
"2608",36,69,163,128,291,0.560137457044674
"2609",36,70,102,79,181,0.56353591160221
"2610",36,71,186,101,287,0.64808362369338
"2611",36,72,170,119,289,0.588235294117647
"2612",36,73,246,213,459,0.535947712418301
"2613",36,74,280,189,469,0.597014925373134
"2614",36,75,148,102,250,0.592
"2615",36,76,30,25,55,0.545454545454545
"2616",36,77,24,15,39,0.615384615384615
"2617",36,78,19,17,36,0.527777777777778
"2618",36,79,24,21,45,0.533333333333333
"2619",36,80,19,24,43,0.441860465116279
"2620",36,81,73,55,128,0.5703125
"2621",36,82,30,32,62,0.483870967741935
"2622",36,83,39,38,77,0.506493506493506
"2623",36,84,82,73,155,0.529032258064516
"2624",36,85,206,114,320,0.64375
"2625",36,86,154,127,281,0.548042704626335
"2626",36,87,90,73,163,0.552147239263804
"2627",36,88,66,34,100,0.66
"2628",36,89,15,18,33,0.454545454545455
"2629",36,90,44,31,75,0.586666666666667
"2630",36,91,33,31,64,0.515625
"2631",36,92,18,16,34,0.529411764705882
"2632",36,93,192,163,355,0.540845070422535
"2633",36,94,72,46,118,0.610169491525424
"2634",36,95,45,30,75,0.6
"2635",36,96,52,32,84,0.619047619047619
"2636",36,97,49,54,103,0.475728155339806
"2637",36,98,52,53,105,0.495238095238095
"2638",36,99,104,88,192,0.541666666666667
"2639",37,100,77,51,128,0.6015625
"2640",37,101,8,8,16,0.5
"2641",37,102,26,11,37,0.702702702702703
"2642",37,103,6,3,9,0.666666666666667
"2643",37,104,60,54,114,0.526315789473684
"2644",37,105,4,12,16,0.25
"2645",37,106,58,59,117,0.495726495726496
"2646",37,107,10,19,29,0.344827586206897
"2647",37,109,9,15,24,0.375
"2648",37,110,18,14,32,0.5625
"2649",37,111,4,6,10,0.4
"2650",37,112,26,29,55,0.472727272727273
"2651",37,38,15,10,25,0.6
"2652",37,39,62,85,147,0.421768707482993
"2653",37,40,14,13,27,0.518518518518518
"2654",37,41,20,25,45,0.444444444444444
"2655",37,42,69,48,117,0.58974358974359
"2656",37,43,8,13,21,0.380952380952381
"2657",37,44,66,62,128,0.515625
"2658",37,45,9,6,15,0.6
"2659",37,46,37,51,88,0.420454545454545
"2660",37,47,37,35,72,0.513888888888889
"2661",37,48,20,10,30,0.666666666666667
"2662",37,49,20,15,35,0.571428571428571
"2663",37,50,43,29,72,0.597222222222222
"2664",37,51,35,33,68,0.514705882352941
"2665",37,52,3,9,12,0.25
"2666",37,53,17,27,44,0.386363636363636
"2667",37,54,11,14,25,0.44
"2668",37,55,32,26,58,0.551724137931034
"2669",37,56,22,16,38,0.578947368421053
"2670",37,57,21,23,44,0.477272727272727
"2671",37,58,4,6,10,0.4
"2672",37,59,49,23,72,0.680555555555556
"2673",37,60,33,20,53,0.622641509433962
"2674",37,61,7,12,19,0.368421052631579
"2675",37,62,41,45,86,0.476744186046512
"2676",37,63,18,16,34,0.529411764705882
"2677",37,64,10,10,20,0.5
"2678",37,65,5,8,13,0.384615384615385
"2679",37,67,73,41,114,0.640350877192982
"2680",37,68,30,23,53,0.566037735849057
"2681",37,69,68,38,106,0.641509433962264
"2682",37,70,44,20,64,0.6875
"2683",37,71,61,43,104,0.586538461538462
"2684",37,72,47,46,93,0.505376344086022
"2685",37,73,80,71,151,0.529801324503311
"2686",37,74,77,64,141,0.546099290780142
"2687",37,75,33,30,63,0.523809523809524
"2688",37,76,12,10,22,0.545454545454545
"2689",37,77,11,5,16,0.6875
"2690",37,78,14,7,21,0.666666666666667
"2691",37,80,5,7,12,0.416666666666667
"2692",37,81,22,21,43,0.511627906976744
"2693",37,82,9,16,25,0.36
"2694",37,83,13,8,21,0.619047619047619
"2695",37,84,22,16,38,0.578947368421053
"2696",37,85,44,39,83,0.530120481927711
"2697",37,86,26,39,65,0.4
"2698",37,87,25,15,40,0.625
"2699",37,88,20,18,38,0.526315789473684
"2700",37,89,5,8,13,0.384615384615385
"2701",37,90,8,7,15,0.533333333333333
"2702",37,92,4,4,8,0.5
"2703",37,93,58,59,117,0.495726495726496
"2704",37,94,26,17,43,0.604651162790698
"2705",37,95,13,16,29,0.448275862068966
"2706",37,96,11,9,20,0.55
"2707",37,97,18,27,45,0.4
"2708",37,98,20,16,36,0.555555555555556
"2709",37,99,34,30,64,0.53125
"2710",38,100,46,38,84,0.547619047619048
"2711",38,101,13,20,33,0.393939393939394
"2712",38,102,15,10,25,0.6
"2713",38,104,32,29,61,0.524590163934426
"2714",38,105,8,5,13,0.615384615384615
"2715",38,106,28,32,60,0.466666666666667
"2716",38,107,11,10,21,0.523809523809524
"2717",38,109,13,11,24,0.541666666666667
"2718",38,110,9,6,15,0.6
"2719",38,111,8,7,15,0.533333333333333
"2720",38,112,52,40,92,0.565217391304348
"2721",38,39,56,41,97,0.577319587628866
"2722",38,40,16,9,25,0.64
"2723",38,41,10,16,26,0.384615384615385
"2724",38,42,41,35,76,0.539473684210526
"2725",38,43,4,7,11,0.363636363636364
"2726",38,44,28,33,61,0.459016393442623
"2727",38,45,9,13,22,0.409090909090909
"2728",38,46,29,30,59,0.491525423728814
"2729",38,47,12,13,25,0.48
"2730",38,48,15,14,29,0.517241379310345
"2731",38,49,15,8,23,0.652173913043478
"2732",38,50,51,42,93,0.548387096774194
"2733",38,51,9,8,17,0.529411764705882
"2734",38,52,5,4,9,0.555555555555556
"2735",38,53,16,20,36,0.444444444444444
"2736",38,54,14,11,25,0.56
"2737",38,55,7,6,13,0.538461538461538
"2738",38,56,8,12,20,0.4
"2739",38,57,28,10,38,0.736842105263158
"2740",38,59,18,15,33,0.545454545454545
"2741",38,60,12,11,23,0.521739130434783
"2742",38,61,3,4,7,0.428571428571429
"2743",38,62,31,37,68,0.455882352941176
"2744",38,63,13,13,26,0.5
"2745",38,64,20,14,34,0.588235294117647
"2746",38,67,40,27,67,0.597014925373134
"2747",38,68,41,36,77,0.532467532467532
"2748",38,69,17,29,46,0.369565217391304
"2749",38,70,29,11,40,0.725
"2750",38,71,25,22,47,0.531914893617021
"2751",38,72,46,28,74,0.621621621621622
"2752",38,73,60,25,85,0.705882352941177
"2753",38,74,56,60,116,0.482758620689655
"2754",38,75,35,31,66,0.53030303030303
"2755",38,76,3,4,7,0.428571428571429
"2756",38,77,9,11,20,0.45
"2757",38,78,7,5,12,0.583333333333333
"2758",38,79,4,6,10,0.4
"2759",38,80,5,4,9,0.555555555555556
"2760",38,81,9,14,23,0.391304347826087
"2761",38,82,8,6,14,0.571428571428571
"2762",38,83,8,8,16,0.5
"2763",38,84,17,18,35,0.485714285714286
"2764",38,85,21,14,35,0.6
"2765",38,86,39,43,82,0.475609756097561
"2766",38,87,22,22,44,0.5
"2767",38,88,5,7,12,0.416666666666667
"2768",38,89,7,3,10,0.7
"2769",38,90,11,6,17,0.647058823529412
"2770",38,91,10,7,17,0.588235294117647
"2771",38,93,40,51,91,0.43956043956044
"2772",38,94,10,10,20,0.5
"2773",38,95,8,10,18,0.444444444444444
"2774",38,97,9,12,21,0.428571428571429
"2775",38,98,8,14,22,0.363636363636364
"2776",38,99,14,15,29,0.482758620689655
"2777",39,100,410,498,908,0.451541850220264
"2778",39,101,81,131,212,0.382075471698113
"2779",39,102,134,126,260,0.515384615384615
"2780",39,103,35,26,61,0.573770491803279
"2781",39,104,271,420,691,0.392185238784371
"2782",39,105,28,56,84,0.333333333333333
"2783",39,106,183,270,453,0.403973509933775
"2784",39,107,126,138,264,0.477272727272727
"2785",39,109,73,61,134,0.544776119402985
"2786",39,110,96,120,216,0.444444444444444
"2787",39,111,19,48,67,0.283582089552239
"2788",39,112,321,440,761,0.421813403416557
"2789",39,40,111,121,232,0.478448275862069
"2790",39,41,89,167,256,0.34765625
"2791",39,42,357,356,713,0.50070126227209
"2792",39,43,24,30,54,0.444444444444444
"2793",39,44,234,300,534,0.438202247191011
"2794",39,45,36,62,98,0.36734693877551
"2795",39,46,90,125,215,0.418604651162791
"2796",39,47,77,109,186,0.413978494623656
"2797",39,48,76,90,166,0.457831325301205
"2798",39,49,52,61,113,0.460176991150442
"2799",39,50,354,415,769,0.460338101430429
"2800",39,51,136,199,335,0.405970149253731
"2801",39,52,17,55,72,0.236111111111111
"2802",39,53,100,172,272,0.367647058823529
"2803",39,54,78,133,211,0.369668246445498
"2804",39,55,172,186,358,0.480446927374302
"2805",39,56,77,90,167,0.461077844311377
"2806",39,57,233,188,421,0.553444180522565
"2807",39,58,17,45,62,0.274193548387097
"2808",39,59,121,138,259,0.467181467181467
"2809",39,60,100,134,234,0.427350427350427
"2810",39,61,39,64,103,0.378640776699029
"2811",39,62,333,315,648,0.513888888888889
"2812",39,63,64,106,170,0.376470588235294
"2813",39,64,113,139,252,0.448412698412698
"2814",39,65,24,49,73,0.328767123287671
"2815",39,66,27,30,57,0.473684210526316
"2816",39,67,316,264,580,0.544827586206897
"2817",39,68,285,340,625,0.456
"2818",39,69,335,350,685,0.489051094890511
"2819",39,70,174,172,346,0.502890173410405
"2820",39,71,346,350,696,0.497126436781609
"2821",39,72,271,319,590,0.459322033898305
"2822",39,73,242,310,552,0.438405797101449
"2823",39,74,182,234,416,0.4375
"2824",39,75,226,279,505,0.447524752475248
"2825",39,76,24,46,70,0.342857142857143
"2826",39,77,38,43,81,0.469135802469136
"2827",39,78,24,33,57,0.421052631578947
"2828",39,79,46,76,122,0.377049180327869
"2829",39,80,33,35,68,0.485294117647059
"2830",39,81,66,119,185,0.356756756756757
"2831",39,82,41,58,99,0.414141414141414
"2832",39,83,80,63,143,0.559440559440559
"2833",39,84,158,234,392,0.403061224489796
"2834",39,85,310,246,556,0.557553956834532
"2835",39,86,289,441,730,0.395890410958904
"2836",39,87,213,213,426,0.5
"2837",39,88,89,117,206,0.432038834951456
"2838",39,89,32,45,77,0.415584415584416
"2839",39,90,61,92,153,0.398692810457516
"2840",39,91,54,90,144,0.375
"2841",39,92,40,54,94,0.425531914893617
"2842",39,93,326,406,732,0.445355191256831
"2843",39,94,68,83,151,0.450331125827815
"2844",39,95,46,56,102,0.450980392156863
"2845",39,96,62,90,152,0.407894736842105
"2846",39,97,86,156,242,0.355371900826446
"2847",39,98,90,133,223,0.403587443946188
"2848",39,99,118,187,305,0.386885245901639
"2849",4,10,15,21,36,0.416666666666667
"2850",4,100,86,96,182,0.472527472527473
"2851",4,101,24,35,59,0.406779661016949
"2852",4,102,33,31,64,0.515625
"2853",4,103,3,11,14,0.214285714285714
"2854",4,104,91,116,207,0.439613526570048
"2855",4,105,4,18,22,0.181818181818182
"2856",4,106,67,72,139,0.482014388489209
"2857",4,107,17,14,31,0.548387096774194
"2858",4,109,20,18,38,0.526315789473684
"2859",4,11,134,145,279,0.480286738351254
"2860",4,110,38,27,65,0.584615384615385
"2861",4,111,9,13,22,0.409090909090909
"2862",4,112,64,69,133,0.481203007518797
"2863",4,12,21,31,52,0.403846153846154
"2864",4,13,16,25,41,0.390243902439024
"2865",4,14,118,114,232,0.508620689655172
"2866",4,15,23,29,52,0.442307692307692
"2867",4,16,19,40,59,0.322033898305085
"2868",4,17,20,45,65,0.307692307692308
"2869",4,18,29,41,70,0.414285714285714
"2870",4,19,54,60,114,0.473684210526316
"2871",4,20,48,39,87,0.551724137931034
"2872",4,21,177,220,397,0.445843828715365
"2873",4,22,67,73,140,0.478571428571429
"2874",4,23,20,29,49,0.408163265306122
"2875",4,25,67,106,173,0.38728323699422
"2876",4,26,60,107,167,0.359281437125749
"2877",4,27,43,32,75,0.573333333333333
"2878",4,28,95,100,195,0.487179487179487
"2879",4,29,25,38,63,0.396825396825397
"2880",4,30,62,80,142,0.436619718309859
"2881",4,31,36,37,73,0.493150684931507
"2882",4,32,43,37,80,0.5375
"2883",4,33,19,23,42,0.452380952380952
"2884",4,34,26,35,61,0.426229508196721
"2885",4,35,37,56,93,0.397849462365591
"2886",4,36,79,94,173,0.456647398843931
"2887",4,37,28,28,56,0.5
"2888",4,38,10,14,24,0.416666666666667
"2889",4,39,66,108,174,0.379310344827586
"2890",4,40,26,32,58,0.448275862068966
"2891",4,41,22,35,57,0.385964912280702
"2892",4,42,75,71,146,0.513698630136986
"2893",4,43,15,30,45,0.333333333333333
"2894",4,44,66,77,143,0.461538461538462
"2895",4,45,16,15,31,0.516129032258065
"2896",4,46,52,75,127,0.409448818897638
"2897",4,47,34,40,74,0.459459459459459
"2898",4,48,26,25,51,0.509803921568627
"2899",4,49,18,23,41,0.439024390243902
"2900",4,5,87,87,174,0.5
"2901",4,50,63,71,134,0.470149253731343
"2902",4,51,36,52,88,0.409090909090909
"2903",4,52,13,21,34,0.382352941176471
"2904",4,53,29,43,72,0.402777777777778
"2905",4,54,21,28,49,0.428571428571429
"2906",4,55,31,30,61,0.508196721311475
"2907",4,56,25,27,52,0.480769230769231
"2908",4,57,62,45,107,0.579439252336449
"2909",4,58,9,13,22,0.409090909090909
"2910",4,59,38,36,74,0.513513513513513
"2911",4,6,24,35,59,0.406779661016949
"2912",4,60,21,36,57,0.368421052631579
"2913",4,61,8,26,34,0.235294117647059
"2914",4,62,49,54,103,0.475728155339806
"2915",4,63,21,26,47,0.446808510638298
"2916",4,64,26,36,62,0.419354838709677
"2917",4,65,8,15,23,0.347826086956522
"2918",4,66,4,10,14,0.285714285714286
"2919",4,67,71,49,120,0.591666666666667
"2920",4,68,58,56,114,0.508771929824561
"2921",4,69,55,57,112,0.491071428571429
"2922",4,7,120,114,234,0.512820512820513
"2923",4,70,55,36,91,0.604395604395604
"2924",4,71,64,72,136,0.470588235294118
"2925",4,72,45,49,94,0.478723404255319
"2926",4,73,93,114,207,0.449275362318841
"2927",4,74,117,164,281,0.416370106761566
"2928",4,75,74,81,155,0.47741935483871
"2929",4,76,11,20,31,0.354838709677419
"2930",4,77,8,6,14,0.571428571428571
"2931",4,78,6,9,15,0.4
"2932",4,79,9,10,19,0.473684210526316
"2933",4,8,74,86,160,0.4625
"2934",4,80,5,15,20,0.25
"2935",4,81,20,28,48,0.416666666666667
"2936",4,82,10,14,24,0.416666666666667
"2937",4,83,27,27,54,0.5
"2938",4,84,42,49,91,0.461538461538462
"2939",4,85,51,47,98,0.520408163265306
"2940",4,86,60,103,163,0.368098159509202
"2941",4,87,51,51,102,0.5
"2942",4,88,22,29,51,0.431372549019608
"2943",4,89,13,8,21,0.619047619047619
"2944",4,9,58,87,145,0.4
"2945",4,90,13,32,45,0.288888888888889
"2946",4,91,12,10,22,0.545454545454545
"2947",4,93,73,74,147,0.496598639455782
"2948",4,94,35,21,56,0.625
"2949",4,95,16,21,37,0.432432432432432
"2950",4,96,15,21,36,0.416666666666667
"2951",4,97,23,34,57,0.403508771929825
"2952",4,98,21,32,53,0.39622641509434
"2953",4,99,33,56,89,0.370786516853933
"2954",40,100,92,83,175,0.525714285714286
"2955",40,101,26,30,56,0.464285714285714
"2956",40,102,50,23,73,0.684931506849315
"2957",40,103,12,7,19,0.631578947368421
"2958",40,104,92,101,193,0.476683937823834
"2959",40,105,6,7,13,0.461538461538462
"2960",40,106,77,74,151,0.509933774834437
"2961",40,107,30,22,52,0.576923076923077
"2962",40,109,22,24,46,0.478260869565217
"2963",40,110,41,23,64,0.640625
"2964",40,111,6,7,13,0.461538461538462
"2965",40,112,61,47,108,0.564814814814815
"2966",40,41,30,56,86,0.348837209302326
"2967",40,42,111,59,170,0.652941176470588
"2968",40,43,26,18,44,0.590909090909091
"2969",40,44,91,106,197,0.461928934010152
"2970",40,45,18,14,32,0.5625
"2971",40,46,62,56,118,0.525423728813559
"2972",40,47,64,51,115,0.556521739130435
"2973",40,48,28,22,50,0.56
"2974",40,49,24,32,56,0.428571428571429
"2975",40,50,73,56,129,0.565891472868217
"2976",40,51,52,41,93,0.559139784946237
"2977",40,52,12,12,24,0.5
"2978",40,53,31,40,71,0.436619718309859
"2979",40,54,32,35,67,0.477611940298507
"2980",40,55,38,41,79,0.481012658227848
"2981",40,56,28,15,43,0.651162790697674
"2982",40,57,52,32,84,0.619047619047619
"2983",40,58,10,10,20,0.5
"2984",40,59,29,42,71,0.408450704225352
"2985",40,60,27,26,53,0.509433962264151
"2986",40,61,11,20,31,0.354838709677419
"2987",40,62,47,56,103,0.456310679611651
"2988",40,63,25,26,51,0.490196078431373
"2989",40,64,28,25,53,0.528301886792453
"2990",40,65,8,9,17,0.470588235294118
"2991",40,66,7,10,17,0.411764705882353
"2992",40,67,97,70,167,0.580838323353293
"2993",40,68,67,66,133,0.503759398496241
"2994",40,69,94,67,161,0.583850931677019
"2995",40,70,64,34,98,0.653061224489796
"2996",40,71,89,59,148,0.601351351351351
"2997",40,72,83,94,177,0.468926553672316
"2998",40,73,114,109,223,0.511210762331839
"2999",40,74,118,144,262,0.450381679389313
"3000",40,75,80,55,135,0.592592592592593
"3001",40,76,22,18,40,0.55
"3002",40,77,8,17,25,0.32
"3003",40,78,16,8,24,0.666666666666667
"3004",40,80,8,9,17,0.470588235294118
"3005",40,81,32,30,62,0.516129032258065
"3006",40,82,21,15,36,0.583333333333333
"3007",40,83,21,14,35,0.6
"3008",40,84,40,37,77,0.519480519480519
"3009",40,85,113,68,181,0.624309392265193
"3010",40,86,55,61,116,0.474137931034483
"3011",40,87,39,20,59,0.661016949152542
"3012",40,88,25,18,43,0.581395348837209
"3013",40,89,7,14,21,0.333333333333333
"3014",40,90,16,21,37,0.432432432432432
"3015",40,91,8,8,16,0.5
"3016",40,92,11,12,23,0.478260869565217
"3017",40,93,105,89,194,0.541237113402062
"3018",40,94,28,19,47,0.595744680851064
"3019",40,95,19,11,30,0.633333333333333
"3020",40,96,18,21,39,0.461538461538462
"3021",40,97,30,42,72,0.416666666666667
"3022",40,98,32,29,61,0.524590163934426
"3023",40,99,42,38,80,0.525
"3024",41,100,75,112,187,0.401069518716578
"3025",41,101,31,79,110,0.281818181818182
"3026",41,102,35,46,81,0.432098765432099
"3027",41,103,12,17,29,0.413793103448276
"3028",41,104,75,95,170,0.441176470588235
"3029",41,105,11,20,31,0.354838709677419
"3030",41,106,36,66,102,0.352941176470588
"3031",41,107,24,27,51,0.470588235294118
"3032",41,109,5,14,19,0.263157894736842
"3033",41,110,59,41,100,0.59
"3034",41,111,7,13,20,0.35
"3035",41,112,72,96,168,0.428571428571429
"3036",41,42,45,42,87,0.517241379310345
"3037",41,43,19,18,37,0.513513513513513
"3038",41,44,25,38,63,0.396825396825397
"3039",41,45,18,18,36,0.5
"3040",41,46,53,60,113,0.469026548672566
"3041",41,47,50,57,107,0.467289719626168
"3042",41,48,11,15,26,0.423076923076923
"3043",41,49,20,22,42,0.476190476190476
"3044",41,50,88,92,180,0.488888888888889
"3045",41,51,44,61,105,0.419047619047619
"3046",41,52,14,26,40,0.35
"3047",41,53,26,45,71,0.366197183098592
"3048",41,54,16,23,39,0.41025641025641
"3049",41,55,46,45,91,0.505494505494505
"3050",41,56,19,23,42,0.452380952380952
"3051",41,57,62,60,122,0.508196721311475
"3052",41,58,11,24,35,0.314285714285714
"3053",41,59,25,24,49,0.510204081632653
"3054",41,60,28,33,61,0.459016393442623
"3055",41,61,12,19,31,0.387096774193548
"3056",41,62,61,76,137,0.445255474452555
"3057",41,63,14,29,43,0.325581395348837
"3058",41,64,52,45,97,0.536082474226804
"3059",41,65,12,7,19,0.631578947368421
"3060",41,66,12,12,24,0.5
"3061",41,67,12,22,34,0.352941176470588
"3062",41,68,89,113,202,0.440594059405941
"3063",41,69,76,74,150,0.506666666666667
"3064",41,70,35,34,69,0.507246376811594
"3065",41,71,63,72,135,0.466666666666667
"3066",41,72,46,42,88,0.522727272727273
"3067",41,73,102,97,199,0.512562814070352
"3068",41,74,170,192,362,0.469613259668508
"3069",41,75,108,94,202,0.534653465346535
"3070",41,76,20,29,49,0.408163265306122
"3071",41,77,7,13,20,0.35
"3072",41,78,12,12,24,0.5
"3073",41,79,11,18,29,0.379310344827586
"3074",41,80,6,13,19,0.315789473684211
"3075",41,81,13,19,32,0.40625
"3076",41,82,8,21,29,0.275862068965517
"3077",41,83,18,20,38,0.473684210526316
"3078",41,84,55,58,113,0.486725663716814
"3079",41,85,61,67,128,0.4765625
"3080",41,86,62,117,179,0.346368715083799
"3081",41,87,48,75,123,0.390243902439024
"3082",41,88,29,45,74,0.391891891891892
"3083",41,89,6,16,22,0.272727272727273
"3084",41,90,20,27,47,0.425531914893617
"3085",41,91,10,22,32,0.3125
"3086",41,92,6,16,22,0.272727272727273
"3087",41,93,31,40,71,0.436619718309859
"3088",41,94,16,11,27,0.592592592592593
"3089",41,95,7,11,18,0.388888888888889
"3090",41,96,15,23,38,0.394736842105263
"3091",41,97,30,47,77,0.38961038961039
"3092",41,98,40,48,88,0.454545454545455
"3093",41,99,44,53,97,0.45360824742268
"3094",42,100,385,235,620,0.620967741935484
"3095",42,101,91,87,178,0.51123595505618
"3096",42,102,116,54,170,0.682352941176471
"3097",42,103,33,11,44,0.75
"3098",42,104,221,166,387,0.571059431524548
"3099",42,105,33,27,60,0.55
"3100",42,106,201,128,329,0.610942249240122
"3101",42,107,122,61,183,0.666666666666667
"3102",42,109,38,20,58,0.655172413793103
"3103",42,110,123,89,212,0.580188679245283
"3104",42,111,45,40,85,0.529411764705882
"3105",42,112,291,229,520,0.559615384615385
"3106",42,43,48,43,91,0.527472527472527
"3107",42,44,121,86,207,0.584541062801932
"3108",42,45,46,41,87,0.528735632183908
"3109",42,46,223,158,381,0.585301837270341
"3110",42,47,126,78,204,0.617647058823529
"3111",42,48,39,32,71,0.549295774647887
"3112",42,49,33,24,57,0.578947368421053
"3113",42,50,336,234,570,0.589473684210526
"3114",42,51,137,100,237,0.578059071729958
"3115",42,52,47,33,80,0.5875
"3116",42,53,78,98,176,0.443181818181818
"3117",42,54,49,35,84,0.583333333333333
"3118",42,55,140,123,263,0.532319391634981
"3119",42,56,56,57,113,0.495575221238938
"3120",42,57,196,99,295,0.664406779661017
"3121",42,58,34,29,63,0.53968253968254
"3122",42,59,86,67,153,0.562091503267974
"3123",42,60,103,59,162,0.635802469135803
"3124",42,61,58,48,106,0.547169811320755
"3125",42,62,234,177,411,0.569343065693431
"3126",42,63,61,50,111,0.54954954954955
"3127",42,64,109,78,187,0.582887700534759
"3128",42,65,36,30,66,0.545454545454545
"3129",42,66,22,13,35,0.628571428571429
"3130",42,67,81,54,135,0.6
"3131",42,68,280,195,475,0.589473684210526
"3132",42,69,280,168,448,0.625
"3133",42,70,118,67,185,0.637837837837838
"3134",42,71,266,148,414,0.642512077294686
"3135",42,72,99,57,156,0.634615384615385
"3136",42,73,303,163,466,0.650214592274678
"3137",42,74,443,291,734,0.603542234332425
"3138",42,75,283,198,481,0.588357588357588
"3139",42,76,46,32,78,0.58974358974359
"3140",42,77,20,10,30,0.666666666666667
"3141",42,78,36,21,57,0.631578947368421
"3142",42,79,59,49,108,0.546296296296296
"3143",42,80,29,24,53,0.547169811320755
"3144",42,81,35,24,59,0.593220338983051
"3145",42,82,47,29,76,0.618421052631579
"3146",42,83,51,40,91,0.56043956043956
"3147",42,84,160,103,263,0.608365019011407
"3148",42,85,241,135,376,0.640957446808511
"3149",42,86,283,249,532,0.531954887218045
"3150",42,87,214,116,330,0.648484848484848
"3151",42,88,87,65,152,0.572368421052632
"3152",42,89,15,16,31,0.483870967741935
"3153",42,90,78,72,150,0.52
"3154",42,91,55,39,94,0.585106382978723
"3155",42,92,40,32,72,0.555555555555556
"3156",42,93,120,95,215,0.558139534883721
"3157",42,94,47,23,70,0.671428571428571
"3158",42,95,42,27,69,0.608695652173913
"3159",42,96,61,34,95,0.642105263157895
"3160",42,97,111,83,194,0.572164948453608
"3161",42,98,87,72,159,0.547169811320755
"3162",42,99,108,84,192,0.5625
"3163",43,100,58,57,115,0.504347826086956
"3164",43,101,11,18,29,0.379310344827586
"3165",43,102,26,15,41,0.634146341463415
"3166",43,103,6,2,8,0.75
"3167",43,104,61,61,122,0.5
"3168",43,105,2,15,17,0.117647058823529
"3169",43,106,30,44,74,0.405405405405405
"3170",43,107,6,14,20,0.3
"3171",43,109,7,7,14,0.5
"3172",43,110,14,14,28,0.5
"3173",43,112,55,42,97,0.56701030927835
"3174",43,44,65,52,117,0.555555555555556
"3175",43,46,20,19,39,0.512820512820513
"3176",43,47,18,11,29,0.620689655172414
"3177",43,48,16,17,33,0.484848484848485
"3178",43,49,14,16,30,0.466666666666667
"3179",43,50,56,48,104,0.538461538461538
"3180",43,51,23,19,42,0.547619047619048
"3181",43,52,7,5,12,0.583333333333333
"3182",43,53,20,33,53,0.377358490566038
"3183",43,54,18,24,42,0.428571428571429
"3184",43,55,18,28,46,0.391304347826087
"3185",43,56,12,14,26,0.461538461538462
"3186",43,57,51,24,75,0.68
"3187",43,59,22,21,43,0.511627906976744
"3188",43,60,27,18,45,0.6
"3189",43,61,5,9,14,0.357142857142857
"3190",43,62,41,46,87,0.471264367816092
"3191",43,63,16,19,35,0.457142857142857
"3192",43,64,19,18,37,0.513513513513513
"3193",43,65,4,9,13,0.307692307692308
"3194",43,66,7,5,12,0.583333333333333
"3195",43,67,42,26,68,0.617647058823529
"3196",43,68,38,37,75,0.506666666666667
"3197",43,69,44,42,86,0.511627906976744
"3198",43,70,45,42,87,0.517241379310345
"3199",43,71,43,41,84,0.511904761904762
"3200",43,72,43,41,84,0.511904761904762
"3201",43,73,44,55,99,0.444444444444444
"3202",43,74,44,54,98,0.448979591836735
"3203",43,75,39,33,72,0.541666666666667
"3204",43,76,5,4,9,0.555555555555556
"3205",43,77,20,7,27,0.740740740740741
"3206",43,78,3,11,14,0.214285714285714
"3207",43,79,6,8,14,0.428571428571429
"3208",43,80,3,8,11,0.272727272727273
"3209",43,81,24,11,35,0.685714285714286
"3210",43,82,10,2,12,0.833333333333333
"3211",43,83,18,16,34,0.529411764705882
"3212",43,84,34,29,63,0.53968253968254
"3213",43,85,50,42,92,0.543478260869565
"3214",43,86,34,51,85,0.4
"3215",43,87,30,16,46,0.652173913043478
"3216",43,88,25,22,47,0.531914893617021
"3217",43,89,3,7,10,0.3
"3218",43,90,18,20,38,0.473684210526316
"3219",43,91,6,6,12,0.5
"3220",43,92,7,7,14,0.5
"3221",43,93,41,57,98,0.418367346938776
"3222",43,94,17,22,39,0.435897435897436
"3223",43,95,15,8,23,0.652173913043478
"3224",43,96,14,17,31,0.451612903225806
"3225",43,97,19,20,39,0.487179487179487
"3226",43,98,16,22,38,0.421052631578947
"3227",43,99,27,38,65,0.415384615384615
"3228",44,100,234,317,551,0.424682395644283
"3229",44,101,67,107,174,0.385057471264368
"3230",44,102,110,78,188,0.585106382978723
"3231",44,103,19,26,45,0.422222222222222
"3232",44,104,187,249,436,0.428899082568807
"3233",44,105,22,47,69,0.318840579710145
"3234",44,106,98,146,244,0.401639344262295
"3235",44,107,62,79,141,0.439716312056738
"3236",44,109,21,14,35,0.6
"3237",44,110,64,80,144,0.444444444444444
"3238",44,111,24,37,61,0.39344262295082
"3239",44,112,174,210,384,0.453125
"3240",44,45,56,45,101,0.554455445544555
"3241",44,46,142,164,306,0.464052287581699
"3242",44,47,71,107,178,0.398876404494382
"3243",44,48,22,26,48,0.458333333333333
"3244",44,49,42,53,95,0.442105263157895
"3245",44,50,246,256,502,0.49003984063745
"3246",44,51,123,130,253,0.486166007905138
"3247",44,52,24,44,68,0.352941176470588
"3248",44,53,69,141,210,0.328571428571429
"3249",44,54,40,70,110,0.363636363636364
"3250",44,55,99,109,208,0.475961538461538
"3251",44,56,42,62,104,0.403846153846154
"3252",44,57,295,197,492,0.599593495934959
"3253",44,58,24,29,53,0.452830188679245
"3254",44,59,69,91,160,0.43125
"3255",44,60,63,85,148,0.425675675675676
"3256",44,61,30,45,75,0.4
"3257",44,62,165,187,352,0.46875
"3258",44,63,53,63,116,0.456896551724138
"3259",44,64,80,70,150,0.533333333333333
"3260",44,65,19,41,60,0.316666666666667
"3261",44,66,16,16,32,0.5
"3262",44,67,57,58,115,0.495652173913044
"3263",44,68,166,216,382,0.43455497382199
"3264",44,69,178,192,370,0.481081081081081
"3265",44,70,101,91,192,0.526041666666667
"3266",44,71,190,190,380,0.5
"3267",44,72,59,73,132,0.446969696969697
"3268",44,73,177,214,391,0.452685421994885
"3269",44,74,321,348,669,0.479820627802691
"3270",44,75,218,215,433,0.503464203233256
"3271",44,76,26,60,86,0.302325581395349
"3272",44,77,13,23,36,0.361111111111111
"3273",44,78,26,27,53,0.490566037735849
"3274",44,79,44,47,91,0.483516483516484
"3275",44,80,22,23,45,0.488888888888889
"3276",44,81,34,44,78,0.435897435897436
"3277",44,82,24,40,64,0.375
"3278",44,83,66,49,115,0.573913043478261
"3279",44,84,133,115,248,0.536290322580645
"3280",44,85,166,136,302,0.549668874172185
"3281",44,86,179,261,440,0.406818181818182
"3282",44,87,147,127,274,0.536496350364963
"3283",44,88,63,71,134,0.470149253731343
"3284",44,89,21,35,56,0.375
"3285",44,90,51,75,126,0.404761904761905
"3286",44,91,32,42,74,0.432432432432432
"3287",44,92,23,33,56,0.410714285714286
"3288",44,93,89,113,202,0.440594059405941
"3289",44,94,37,29,66,0.560606060606061
"3290",44,95,30,28,58,0.517241379310345
"3291",44,96,52,55,107,0.485981308411215
"3292",44,97,91,152,243,0.374485596707819
"3293",44,98,72,95,167,0.431137724550898
"3294",44,99,124,159,283,0.438162544169611
"3295",45,100,45,51,96,0.46875
"3296",45,101,6,10,16,0.375
"3297",45,102,13,15,28,0.464285714285714
"3298",45,104,41,70,111,0.369369369369369
"3299",45,106,51,39,90,0.566666666666667
"3300",45,107,7,9,16,0.4375
"3301",45,109,5,12,17,0.294117647058824
"3302",45,110,18,13,31,0.580645161290323
"3303",45,112,20,24,44,0.454545454545455
"3304",45,46,46,35,81,0.567901234567901
"3305",45,47,19,26,45,0.422222222222222
"3306",45,48,10,14,24,0.416666666666667
"3307",45,49,7,9,16,0.4375
"3308",45,50,36,28,64,0.5625
"3309",45,51,29,16,45,0.644444444444444
"3310",45,52,13,5,18,0.722222222222222
"3311",45,53,15,20,35,0.428571428571429
"3312",45,54,8,18,26,0.307692307692308
"3313",45,55,17,10,27,0.62962962962963
"3314",45,56,6,18,24,0.25
"3315",45,57,18,22,40,0.45
"3316",45,59,27,18,45,0.6
"3317",45,60,13,18,31,0.419354838709677
"3318",45,61,8,6,14,0.571428571428571
"3319",45,62,27,36,63,0.428571428571429
"3320",45,63,15,16,31,0.483870967741935
"3321",45,64,15,15,30,0.5
"3322",45,65,3,4,7,0.428571428571429
"3323",45,66,4,5,9,0.444444444444444
"3324",45,67,49,39,88,0.556818181818182
"3325",45,68,18,22,40,0.45
"3326",45,69,48,28,76,0.631578947368421
"3327",45,70,37,18,55,0.672727272727273
"3328",45,71,51,36,87,0.586206896551724
"3329",45,72,51,37,88,0.579545454545455
"3330",45,73,60,66,126,0.476190476190476
"3331",45,74,59,63,122,0.483606557377049
"3332",45,75,28,32,60,0.466666666666667
"3333",45,76,5,5,10,0.5
"3334",45,77,5,7,12,0.416666666666667
"3335",45,78,5,11,16,0.3125
"3336",45,79,6,5,11,0.545454545454545
"3337",45,80,6,7,13,0.461538461538462
"3338",45,81,20,11,31,0.645161290322581
"3339",45,82,10,11,21,0.476190476190476
"3340",45,83,10,4,14,0.714285714285714
"3341",45,84,19,26,45,0.422222222222222
"3342",45,85,31,26,57,0.543859649122807
"3343",45,86,28,32,60,0.466666666666667
"3344",45,87,12,14,26,0.461538461538462
"3345",45,88,16,19,35,0.457142857142857
"3346",45,90,8,4,12,0.666666666666667
"3347",45,91,7,4,11,0.636363636363636
"3348",45,93,49,49,98,0.5
"3349",45,94,9,12,21,0.428571428571429
"3350",45,95,9,13,22,0.409090909090909
"3351",45,96,11,13,24,0.458333333333333
"3352",45,97,12,27,39,0.307692307692308
"3353",45,98,14,20,34,0.411764705882353
"3354",45,99,19,24,43,0.441860465116279
"3355",46,100,310,238,548,0.565693430656934
"3356",46,101,69,95,164,0.420731707317073
"3357",46,102,103,66,169,0.609467455621302
"3358",46,103,23,15,38,0.605263157894737
"3359",46,104,164,193,357,0.459383753501401
"3360",46,105,26,38,64,0.40625
"3361",46,106,98,120,218,0.44954128440367
"3362",46,107,84,67,151,0.556291390728477
"3363",46,109,27,30,57,0.473684210526316
"3364",46,110,61,67,128,0.4765625
"3365",46,111,21,23,44,0.477272727272727
"3366",46,112,225,195,420,0.535714285714286
"3367",46,47,46,60,106,0.433962264150943
"3368",46,48,43,52,95,0.452631578947368
"3369",46,49,26,28,54,0.481481481481481
"3370",46,50,225,226,451,0.498891352549889
"3371",46,51,120,88,208,0.576923076923077
"3372",46,52,15,27,42,0.357142857142857
"3373",46,53,59,75,134,0.440298507462687
"3374",46,54,46,60,106,0.433962264150943
"3375",46,55,112,105,217,0.516129032258065
"3376",46,56,40,53,93,0.43010752688172
"3377",46,57,156,109,265,0.588679245283019
"3378",46,58,21,26,47,0.446808510638298
"3379",46,59,71,75,146,0.486301369863014
"3380",46,60,65,72,137,0.474452554744526
"3381",46,61,31,45,76,0.407894736842105
"3382",46,62,173,130,303,0.570957095709571
"3383",46,63,43,63,106,0.405660377358491
"3384",46,64,61,64,125,0.488
"3385",46,65,20,35,55,0.363636363636364
"3386",46,66,9,13,22,0.409090909090909
"3387",46,67,179,122,301,0.59468438538206
"3388",46,68,165,169,334,0.494011976047904
"3389",46,69,235,201,436,0.538990825688073
"3390",46,70,101,77,178,0.567415730337079
"3391",46,71,167,161,328,0.509146341463415
"3392",46,72,179,155,334,0.535928143712575
"3393",46,73,103,111,214,0.481308411214953
"3394",46,74,107,106,213,0.502347417840376
"3395",46,75,144,158,302,0.47682119205298
"3396",46,76,22,14,36,0.611111111111111
"3397",46,77,18,25,43,0.418604651162791
"3398",46,78,20,14,34,0.588235294117647
"3399",46,79,37,37,74,0.5
"3400",46,80,14,32,46,0.304347826086957
"3401",46,81,53,51,104,0.509615384615385
"3402",46,82,25,26,51,0.490196078431373
"3403",46,83,38,32,70,0.542857142857143
"3404",46,84,136,93,229,0.593886462882096
"3405",46,85,165,135,300,0.55
"3406",46,86,236,224,460,0.51304347826087
"3407",46,87,126,107,233,0.540772532188841
"3408",46,88,52,67,119,0.436974789915966
"3409",46,89,16,26,42,0.380952380952381
"3410",46,90,42,44,86,0.488372093023256
"3411",46,91,33,37,70,0.471428571428571
"3412",46,92,24,14,38,0.631578947368421
"3413",46,93,186,197,383,0.485639686684073
"3414",46,94,47,40,87,0.540229885057471
"3415",46,95,24,50,74,0.324324324324324
"3416",46,96,47,35,82,0.573170731707317
"3417",46,97,36,58,94,0.382978723404255
"3418",46,98,67,82,149,0.449664429530201
"3419",46,99,92,95,187,0.491978609625668
"3420",47,100,143,132,275,0.52
"3421",47,101,44,49,93,0.473118279569892
"3422",47,102,61,44,105,0.580952380952381
"3423",47,103,14,13,27,0.518518518518518
"3424",47,104,126,127,253,0.49802371541502
"3425",47,105,20,12,32,0.625
"3426",47,106,67,92,159,0.421383647798742
"3427",47,107,42,26,68,0.617647058823529
"3428",47,109,22,23,45,0.488888888888889
"3429",47,110,46,30,76,0.605263157894737
"3430",47,111,12,27,39,0.307692307692308
"3431",47,112,123,116,239,0.514644351464435
"3432",47,48,26,36,62,0.419354838709677
"3433",47,49,26,22,48,0.541666666666667
"3434",47,50,117,110,227,0.515418502202643
"3435",47,51,33,58,91,0.362637362637363
"3436",47,52,6,15,21,0.285714285714286
"3437",47,53,35,54,89,0.393258426966292
"3438",47,54,39,36,75,0.52
"3439",47,55,50,50,100,0.5
"3440",47,56,22,27,49,0.448979591836735
"3441",47,57,85,72,157,0.54140127388535
"3442",47,58,6,18,24,0.25
"3443",47,59,39,43,82,0.475609756097561
"3444",47,60,42,29,71,0.591549295774648
"3445",47,61,17,19,36,0.472222222222222
"3446",47,62,87,105,192,0.453125
"3447",47,63,22,37,59,0.372881355932203
"3448",47,64,37,42,79,0.468354430379747
"3449",47,65,8,13,21,0.380952380952381
"3450",47,66,5,12,17,0.294117647058824
"3451",47,67,96,68,164,0.585365853658537
"3452",47,68,103,113,216,0.476851851851852
"3453",47,69,91,91,182,0.5
"3454",47,70,57,51,108,0.527777777777778
"3455",47,71,100,104,204,0.490196078431373
"3456",47,72,78,66,144,0.541666666666667
"3457",47,73,113,98,211,0.535545023696682
"3458",47,74,121,107,228,0.530701754385965
"3459",47,75,97,92,189,0.513227513227513
"3460",47,76,9,22,31,0.290322580645161
"3461",47,77,16,13,29,0.551724137931034
"3462",47,78,13,10,23,0.565217391304348
"3463",47,79,20,15,35,0.571428571428571
"3464",47,80,12,15,27,0.444444444444444
"3465",47,81,43,37,80,0.5375
"3466",47,82,15,22,37,0.405405405405405
"3467",47,83,29,26,55,0.527272727272727
"3468",47,84,75,78,153,0.490196078431373
"3469",47,85,124,87,211,0.587677725118483
"3470",47,86,82,127,209,0.392344497607655
"3471",47,87,76,48,124,0.612903225806452
"3472",47,88,31,39,70,0.442857142857143
"3473",47,89,15,15,30,0.5
"3474",47,90,24,30,54,0.444444444444444
"3475",47,91,21,21,42,0.5
"3476",47,92,18,14,32,0.5625
"3477",47,93,118,99,217,0.543778801843318
"3478",47,94,43,34,77,0.558441558441558
"3479",47,95,27,23,50,0.54
"3480",47,96,26,24,50,0.52
"3481",47,97,25,28,53,0.471698113207547
"3482",47,98,28,37,65,0.430769230769231
"3483",47,99,46,69,115,0.4
"3484",48,100,90,94,184,0.489130434782609
"3485",48,101,26,26,52,0.5
"3486",48,102,44,28,72,0.611111111111111
"3487",48,103,10,7,17,0.588235294117647
"3488",48,104,68,67,135,0.503703703703704
"3489",48,105,16,18,34,0.470588235294118
"3490",48,106,60,43,103,0.58252427184466
"3491",48,107,25,30,55,0.454545454545455
"3492",48,109,5,10,15,0.333333333333333
"3493",48,110,32,32,64,0.5
"3494",48,111,12,14,26,0.461538461538462
"3495",48,112,77,62,139,0.553956834532374
"3496",48,49,10,14,24,0.416666666666667
"3497",48,50,85,67,152,0.559210526315789
"3498",48,51,48,36,84,0.571428571428571
"3499",48,52,8,12,20,0.4
"3500",48,53,27,34,61,0.442622950819672
"3501",48,54,18,25,43,0.418604651162791
"3502",48,55,45,36,81,0.555555555555556
"3503",48,56,13,15,28,0.464285714285714
"3504",48,57,74,52,126,0.587301587301587
"3505",48,58,14,18,32,0.4375
"3506",48,59,25,22,47,0.531914893617021
"3507",48,60,31,23,54,0.574074074074074
"3508",48,61,8,21,29,0.275862068965517
"3509",48,62,61,51,112,0.544642857142857
"3510",48,63,19,15,34,0.558823529411765
"3511",48,64,40,27,67,0.597014925373134
"3512",48,65,10,8,18,0.555555555555556
"3513",48,66,6,4,10,0.6
"3514",48,67,15,7,22,0.681818181818182
"3515",48,68,65,54,119,0.546218487394958
"3516",48,69,66,58,124,0.532258064516129
"3517",48,70,41,23,64,0.640625
"3518",48,71,82,55,137,0.598540145985402
"3519",48,72,24,20,44,0.545454545454545
"3520",48,73,81,74,155,0.52258064516129
"3521",48,74,92,92,184,0.5
"3522",48,75,65,47,112,0.580357142857143
"3523",48,76,20,7,27,0.740740740740741
"3524",48,77,8,5,13,0.615384615384615
"3525",48,78,8,7,15,0.533333333333333
"3526",48,79,4,24,28,0.142857142857143
"3527",48,80,5,5,10,0.5
"3528",48,81,10,13,23,0.434782608695652
"3529",48,82,13,7,20,0.65
"3530",48,83,24,13,37,0.648648648648649
"3531",48,84,57,43,100,0.57
"3532",48,85,65,40,105,0.619047619047619
"3533",48,86,75,67,142,0.528169014084507
"3534",48,87,48,37,85,0.564705882352941
"3535",48,88,38,22,60,0.633333333333333
"3536",48,89,2,5,7,0.285714285714286
"3537",48,90,13,24,37,0.351351351351351
"3538",48,91,13,3,16,0.8125
"3539",48,92,10,10,20,0.5
"3540",48,93,25,35,60,0.416666666666667
"3541",48,94,6,12,18,0.333333333333333
"3542",48,95,5,9,14,0.357142857142857
"3543",48,96,21,23,44,0.477272727272727
"3544",48,97,26,25,51,0.509803921568627
"3545",48,98,33,26,59,0.559322033898305
"3546",48,99,47,31,78,0.602564102564103
"3547",49,100,58,57,115,0.504347826086956
"3548",49,101,16,28,44,0.363636363636364
"3549",49,102,30,20,50,0.6
"3550",49,103,10,5,15,0.666666666666667
"3551",49,104,59,73,132,0.446969696969697
"3552",49,105,11,9,20,0.55
"3553",49,106,42,30,72,0.583333333333333
"3554",49,107,17,16,33,0.515151515151515
"3555",49,109,10,8,18,0.555555555555556
"3556",49,110,17,18,35,0.485714285714286
"3557",49,111,9,7,16,0.5625
"3558",49,112,52,63,115,0.452173913043478
"3559",49,50,77,70,147,0.523809523809524
"3560",49,51,34,16,50,0.68
"3561",49,52,8,12,20,0.4
"3562",49,53,24,31,55,0.436363636363636
"3563",49,54,11,17,28,0.392857142857143
"3564",49,55,24,24,48,0.5
"3565",49,56,14,14,28,0.5
"3566",49,57,41,28,69,0.594202898550725
"3567",49,58,9,11,20,0.45
"3568",49,59,27,26,53,0.509433962264151
"3569",49,60,17,14,31,0.548387096774194
"3570",49,61,8,10,18,0.444444444444444
"3571",49,62,47,60,107,0.439252336448598
"3572",49,63,16,21,37,0.432432432432432
"3573",49,64,25,33,58,0.431034482758621
"3574",49,65,8,3,11,0.727272727272727
"3575",49,66,3,10,13,0.230769230769231
"3576",49,67,47,21,68,0.691176470588235
"3577",49,68,57,52,109,0.522935779816514
"3578",49,69,52,28,80,0.65
"3579",49,70,33,14,47,0.702127659574468
"3580",49,71,40,33,73,0.547945205479452
"3581",49,72,41,46,87,0.471264367816092
"3582",49,73,55,69,124,0.443548387096774
"3583",49,74,73,79,152,0.480263157894737
"3584",49,75,54,51,105,0.514285714285714
"3585",49,76,8,9,17,0.470588235294118
"3586",49,77,9,9,18,0.5
"3587",49,79,10,15,25,0.4
"3588",49,80,5,7,12,0.416666666666667
"3589",49,81,10,8,18,0.555555555555556
"3590",49,82,8,7,15,0.533333333333333
"3591",49,83,6,10,16,0.375
"3592",49,84,34,44,78,0.435897435897436
"3593",49,85,31,35,66,0.46969696969697
"3594",49,86,51,71,122,0.418032786885246
"3595",49,87,43,27,70,0.614285714285714
"3596",49,88,17,16,33,0.515151515151515
"3597",49,89,11,14,25,0.44
"3598",49,90,20,27,47,0.425531914893617
"3599",49,91,9,15,24,0.375
"3600",49,92,7,5,12,0.583333333333333
"3601",49,93,48,51,99,0.484848484848485
"3602",49,94,26,20,46,0.565217391304348
"3603",49,95,8,7,15,0.533333333333333
"3604",49,96,14,12,26,0.538461538461538
"3605",49,97,15,18,33,0.454545454545455
"3606",49,98,13,25,38,0.342105263157895
"3607",49,99,13,23,36,0.361111111111111
"3608",5,10,43,47,90,0.477777777777778
"3609",5,100,301,268,569,0.528998242530756
"3610",5,101,46,59,105,0.438095238095238
"3611",5,102,99,45,144,0.6875
"3612",5,103,25,19,44,0.568181818181818
"3613",5,104,300,239,539,0.556586270871985
"3614",5,105,29,30,59,0.491525423728814
"3615",5,106,248,221,469,0.528784648187633
"3616",5,107,78,55,133,0.586466165413534
"3617",5,109,51,50,101,0.504950495049505
"3618",5,11,559,458,1017,0.549655850540806
"3619",5,110,87,70,157,0.554140127388535
"3620",5,111,15,17,32,0.46875
"3621",5,112,107,109,216,0.49537037037037
"3622",5,12,113,133,246,0.459349593495935
"3623",5,13,46,55,101,0.455445544554455
"3624",5,14,294,230,524,0.561068702290076
"3625",5,15,72,63,135,0.533333333333333
"3626",5,16,79,76,155,0.509677419354839
"3627",5,17,86,77,163,0.52760736196319
"3628",5,18,148,117,265,0.558490566037736
"3629",5,19,206,151,357,0.57703081232493
"3630",5,20,67,62,129,0.51937984496124
"3631",5,21,640,590,1230,0.520325203252033
"3632",5,22,177,120,297,0.595959595959596
"3633",5,23,80,86,166,0.481927710843373
"3634",5,25,160,247,407,0.393120393120393
"3635",5,26,95,84,179,0.53072625698324
"3636",5,27,53,48,101,0.524752475247525
"3637",5,28,388,274,662,0.586102719033233
"3638",5,29,71,70,141,0.50354609929078
"3639",5,30,107,110,217,0.493087557603687
"3640",5,31,77,66,143,0.538461538461538
"3641",5,32,168,113,281,0.597864768683274
"3642",5,33,67,55,122,0.549180327868853
"3643",5,34,64,91,155,0.412903225806452
"3644",5,35,97,121,218,0.444954128440367
"3645",5,36,173,128,301,0.574750830564784
"3646",5,37,40,29,69,0.579710144927536
"3647",5,38,37,28,65,0.569230769230769
"3648",5,39,268,360,628,0.426751592356688
"3649",5,40,71,41,112,0.633928571428571
"3650",5,41,102,120,222,0.459459459459459
"3651",5,42,309,188,497,0.621730382293763
"3652",5,43,62,42,104,0.596153846153846
"3653",5,44,228,240,468,0.487179487179487
"3654",5,45,29,25,54,0.537037037037037
"3655",5,46,212,184,396,0.535353535353535
"3656",5,47,133,96,229,0.580786026200873
"3657",5,48,82,72,154,0.532467532467532
"3658",5,49,80,57,137,0.583941605839416
"3659",5,50,124,94,218,0.568807339449541
"3660",5,51,138,131,269,0.513011152416357
"3661",5,52,36,20,56,0.642857142857143
"3662",5,53,64,85,149,0.429530201342282
"3663",5,54,75,79,154,0.487012987012987
"3664",5,55,153,100,253,0.604743083003953
"3665",5,56,87,75,162,0.537037037037037
"3666",5,57,131,67,198,0.661616161616162
"3667",5,58,21,19,40,0.525
"3668",5,59,101,119,220,0.459090909090909
"3669",5,6,69,69,138,0.5
"3670",5,60,113,80,193,0.585492227979275
"3671",5,61,47,44,91,0.516483516483517
"3672",5,62,176,145,321,0.548286604361371
"3673",5,63,101,87,188,0.537234042553192
"3674",5,64,48,42,90,0.533333333333333
"3675",5,65,33,20,53,0.622641509433962
"3676",5,66,19,12,31,0.612903225806452
"3677",5,67,285,204,489,0.582822085889571
"3678",5,68,85,91,176,0.482954545454545
"3679",5,69,264,211,475,0.55578947368421
"3680",5,7,277,214,491,0.564154786150713
"3681",5,70,191,121,312,0.612179487179487
"3682",5,71,234,187,421,0.555819477434679
"3683",5,72,221,222,443,0.498871331828442
"3684",5,73,386,271,657,0.58751902587519
"3685",5,74,377,344,721,0.522884882108183
"3686",5,75,174,130,304,0.572368421052632
"3687",5,76,57,44,101,0.564356435643564
"3688",5,77,35,26,61,0.573770491803279
"3689",5,78,35,24,59,0.593220338983051
"3690",5,79,15,25,40,0.375
"3691",5,8,510,375,885,0.576271186440678
"3692",5,80,29,27,56,0.517857142857143
"3693",5,81,92,82,174,0.528735632183908
"3694",5,82,51,49,100,0.51
"3695",5,83,45,34,79,0.569620253164557
"3696",5,84,87,76,163,0.533742331288344
"3697",5,85,191,141,332,0.575301204819277
"3698",5,86,112,125,237,0.472573839662447
"3699",5,87,75,64,139,0.539568345323741
"3700",5,88,77,67,144,0.534722222222222
"3701",5,89,27,32,59,0.457627118644068
"3702",5,9,201,147,348,0.577586206896552
"3703",5,90,32,23,55,0.581818181818182
"3704",5,91,20,36,56,0.357142857142857
"3705",5,92,17,14,31,0.548387096774194
"3706",5,93,263,254,517,0.508704061895551
"3707",5,94,89,62,151,0.589403973509934
"3708",5,95,55,48,103,0.533980582524272
"3709",5,96,62,72,134,0.462686567164179
"3710",5,97,115,113,228,0.504385964912281
"3711",5,98,112,119,231,0.484848484848485
"3712",5,99,205,169,374,0.548128342245989
"3713",50,100,379,311,690,0.549275362318841
"3714",50,101,48,65,113,0.424778761061947
"3715",50,102,87,55,142,0.612676056338028
"3716",50,103,19,29,48,0.395833333333333
"3717",50,104,289,281,570,0.507017543859649
"3718",50,105,26,28,54,0.481481481481481
"3719",50,106,279,274,553,0.504520795660036
"3720",50,107,83,78,161,0.515527950310559
"3721",50,109,69,49,118,0.584745762711864
"3722",50,110,104,85,189,0.55026455026455
"3723",50,111,25,21,46,0.543478260869565
"3724",50,112,136,111,247,0.550607287449393
"3725",50,51,140,126,266,0.526315789473684
"3726",50,52,30,32,62,0.483870967741935
"3727",50,53,79,87,166,0.475903614457831
"3728",50,54,56,66,122,0.459016393442623
"3729",50,55,150,129,279,0.537634408602151
"3730",50,56,78,71,149,0.523489932885906
"3731",50,57,105,55,160,0.65625
"3732",50,58,21,24,45,0.466666666666667
"3733",50,59,364,308,672,0.541666666666667
"3734",50,60,86,101,187,0.459893048128342
"3735",50,61,42,65,107,0.392523364485981
"3736",50,62,183,155,338,0.541420118343195
"3737",50,63,84,59,143,0.587412587412587
"3738",50,64,63,48,111,0.567567567567568
"3739",50,65,24,39,63,0.380952380952381
"3740",50,66,13,13,26,0.5
"3741",50,67,324,177,501,0.646706586826347
"3742",50,68,93,91,184,0.505434782608696
"3743",50,69,309,228,537,0.575418994413408
"3744",50,70,158,113,271,0.583025830258303
"3745",50,71,257,208,465,0.552688172043011
"3746",50,72,260,246,506,0.513833992094862
"3747",50,73,401,313,714,0.561624649859944
"3748",50,74,396,375,771,0.513618677042802
"3749",50,75,139,132,271,0.512915129151292
"3750",50,76,56,45,101,0.554455445544555
"3751",50,77,39,25,64,0.609375
"3752",50,78,33,33,66,0.5
"3753",50,79,31,31,62,0.5
"3754",50,80,20,30,50,0.4
"3755",50,81,79,83,162,0.487654320987654
"3756",50,82,81,66,147,0.551020408163265
"3757",50,83,37,25,62,0.596774193548387
"3758",50,84,91,83,174,0.522988505747126
"3759",50,85,228,138,366,0.622950819672131
"3760",50,86,138,158,296,0.466216216216216
"3761",50,87,74,72,146,0.506849315068493
"3762",50,88,90,80,170,0.529411764705882
"3763",50,89,35,28,63,0.555555555555556
"3764",50,90,22,29,51,0.431372549019608
"3765",50,91,32,47,79,0.40506329113924
"3766",50,92,20,14,34,0.588235294117647
"3767",50,93,254,289,543,0.467771639042357
"3768",50,94,88,70,158,0.556962025316456
"3769",50,95,61,49,110,0.554545454545455
"3770",50,96,77,70,147,0.523809523809524
"3771",50,97,106,128,234,0.452991452991453
"3772",50,98,82,85,167,0.491017964071856
"3773",50,99,162,151,313,0.517571884984026
"3774",51,100,95,112,207,0.458937198067633
"3775",51,101,68,66,134,0.507462686567164
"3776",51,102,47,38,85,0.552941176470588
"3777",51,103,4,5,9,0.444444444444444
"3778",51,104,123,120,243,0.506172839506173
"3779",51,105,10,15,25,0.4
"3780",51,106,116,169,285,0.407017543859649
"3781",51,107,32,25,57,0.56140350877193
"3782",51,109,27,36,63,0.428571428571429
"3783",51,110,21,16,37,0.567567567567568
"3784",51,111,14,13,27,0.518518518518518
"3785",51,112,164,144,308,0.532467532467532
"3786",51,52,11,17,28,0.392857142857143
"3787",51,53,50,62,112,0.446428571428571
"3788",51,54,39,57,96,0.40625
"3789",51,55,16,14,30,0.533333333333333
"3790",51,56,38,27,65,0.584615384615385
"3791",51,57,97,69,166,0.58433734939759
"3792",51,58,10,16,26,0.384615384615385
"3793",51,59,49,40,89,0.550561797752809
"3794",51,60,22,32,54,0.407407407407407
"3795",51,62,129,104,233,0.553648068669528
"3796",51,63,17,20,37,0.459459459459459
"3797",51,64,45,50,95,0.473684210526316
"3798",51,65,7,11,18,0.388888888888889
"3799",51,66,15,9,24,0.625
"3800",51,67,160,118,278,0.575539568345324
"3801",51,68,133,147,280,0.475
"3802",51,69,70,63,133,0.526315789473684
"3803",51,70,83,47,130,0.638461538461538
"3804",51,71,75,53,128,0.5859375
"3805",51,72,102,131,233,0.437768240343348
"3806",51,73,195,166,361,0.54016620498615
"3807",51,74,204,205,409,0.498777506112469
"3808",51,75,140,114,254,0.551181102362205
"3809",51,76,19,31,50,0.38
"3810",51,77,17,18,35,0.485714285714286
"3811",51,78,6,13,19,0.315789473684211
"3812",51,79,29,23,52,0.557692307692308
"3813",51,80,11,19,30,0.366666666666667
"3814",51,81,34,26,60,0.566666666666667
"3815",51,82,20,27,47,0.425531914893617
"3816",51,83,21,18,39,0.538461538461538
"3817",51,84,64,67,131,0.488549618320611
"3818",51,85,53,55,108,0.490740740740741
"3819",51,86,163,188,351,0.464387464387464
"3820",51,87,86,86,172,0.5
"3821",51,88,28,16,44,0.636363636363636
"3822",51,89,7,16,23,0.304347826086957
"3823",51,90,38,32,70,0.542857142857143
"3824",51,91,30,30,60,0.5
"3825",51,92,11,23,34,0.323529411764706
"3826",51,93,123,139,262,0.469465648854962
"3827",51,94,36,36,72,0.5
"3828",51,95,23,17,40,0.575
"3829",51,96,8,8,16,0.5
"3830",51,97,22,35,57,0.385964912280702
"3831",51,98,9,16,25,0.36
"3832",51,99,16,22,38,0.421052631578947
"3833",52,100,40,43,83,0.481927710843373
"3834",52,101,16,22,38,0.421052631578947
"3835",52,102,15,13,28,0.535714285714286
"3836",52,104,39,52,91,0.428571428571429
"3837",52,105,3,4,7,0.428571428571429
"3838",52,106,18,35,53,0.339622641509434
"3839",52,107,9,11,20,0.45
"3840",52,110,9,11,20,0.45
"3841",52,111,3,4,7,0.428571428571429
"3842",52,112,30,37,67,0.447761194029851
"3843",52,53,6,18,24,0.25
"3844",52,54,13,17,30,0.433333333333333
"3845",52,55,18,13,31,0.580645161290323
"3846",52,56,6,10,16,0.375
"3847",52,57,22,14,36,0.611111111111111
"3848",52,59,17,21,38,0.447368421052632
"3849",52,60,14,18,32,0.4375
"3850",52,61,6,6,12,0.5
"3851",52,62,28,26,54,0.518518518518518
"3852",52,63,6,12,18,0.333333333333333
"3853",52,64,12,14,26,0.461538461538462
"3854",52,67,42,19,61,0.688524590163934
"3855",52,68,17,26,43,0.395348837209302
"3856",52,69,40,27,67,0.597014925373134
"3857",52,70,17,22,39,0.435897435897436
"3858",52,71,23,39,62,0.370967741935484
"3859",52,72,27,26,53,0.509433962264151
"3860",52,73,46,46,92,0.5
"3861",52,74,40,53,93,0.43010752688172
"3862",52,75,32,21,53,0.60377358490566
"3863",52,76,7,8,15,0.466666666666667
"3864",52,77,7,4,11,0.636363636363636
"3865",52,79,11,14,25,0.44
"3866",52,81,10,20,30,0.333333333333333
"3867",52,82,9,4,13,0.692307692307692
"3868",52,83,8,6,14,0.571428571428571
"3869",52,84,16,13,29,0.551724137931034
"3870",52,85,22,36,58,0.379310344827586
"3871",52,86,20,33,53,0.377358490566038
"3872",52,87,13,20,33,0.393939393939394
"3873",52,88,10,21,31,0.32258064516129
"3874",52,90,14,9,23,0.608695652173913
"3875",52,91,6,6,12,0.5
"3876",52,93,38,41,79,0.481012658227848
"3877",52,94,10,7,17,0.588235294117647
"3878",52,95,10,5,15,0.666666666666667
"3879",52,96,9,11,20,0.45
"3880",52,97,11,18,29,0.379310344827586
"3881",52,98,11,12,23,0.478260869565217
"3882",52,99,20,21,41,0.48780487804878
"3883",53,100,86,108,194,0.443298969072165
"3884",53,101,22,33,55,0.4
"3885",53,102,41,33,74,0.554054054054054
"3886",53,103,7,15,22,0.318181818181818
"3887",53,104,80,99,179,0.446927374301676
"3888",53,105,7,21,28,0.25
"3889",53,106,67,139,206,0.325242718446602
"3890",53,107,19,32,51,0.372549019607843
"3891",53,109,24,34,58,0.413793103448276
"3892",53,110,32,36,68,0.470588235294118
"3893",53,111,7,12,19,0.368421052631579
"3894",53,112,66,75,141,0.468085106382979
"3895",53,54,11,33,44,0.25
"3896",53,55,44,48,92,0.478260869565217
"3897",53,56,21,36,57,0.368421052631579
"3898",53,57,57,59,116,0.491379310344828
"3899",53,58,6,12,18,0.333333333333333
"3900",53,59,28,65,93,0.301075268817204
"3901",53,60,32,33,65,0.492307692307692
"3902",53,61,20,28,48,0.416666666666667
"3903",53,62,42,71,113,0.371681415929204
"3904",53,63,22,33,55,0.4
"3905",53,64,23,32,55,0.418181818181818
"3906",53,65,5,16,21,0.238095238095238
"3907",53,66,7,6,13,0.538461538461538
"3908",53,67,107,90,197,0.543147208121827
"3909",53,68,57,81,138,0.41304347826087
"3910",53,69,60,89,149,0.402684563758389
"3911",53,70,42,45,87,0.482758620689655
"3912",53,71,75,88,163,0.460122699386503
"3913",53,72,68,91,159,0.427672955974843
"3914",53,73,126,158,284,0.443661971830986
"3915",53,74,129,175,304,0.424342105263158
"3916",53,75,55,71,126,0.436507936507937
"3917",53,76,13,27,40,0.325
"3918",53,77,11,18,29,0.379310344827586
"3919",53,78,9,11,20,0.45
"3920",53,79,10,16,26,0.384615384615385
"3921",53,80,8,14,22,0.363636363636364
"3922",53,81,34,38,72,0.472222222222222
"3923",53,82,17,29,46,0.369565217391304
"3924",53,83,17,20,37,0.459459459459459
"3925",53,84,37,57,94,0.393617021276596
"3926",53,85,55,57,112,0.491071428571429
"3927",53,86,66,95,161,0.409937888198758
"3928",53,87,35,53,88,0.397727272727273
"3929",53,88,22,31,53,0.415094339622642
"3930",53,89,8,11,19,0.421052631578947
"3931",53,90,14,32,46,0.304347826086957
"3932",53,91,8,14,22,0.363636363636364
"3933",53,92,11,7,18,0.611111111111111
"3934",53,93,87,140,227,0.383259911894273
"3935",53,94,30,38,68,0.441176470588235
"3936",53,95,18,24,42,0.428571428571429
"3937",53,96,16,31,47,0.340425531914894
"3938",53,97,26,54,80,0.325
"3939",53,98,25,58,83,0.301204819277108
"3940",53,99,39,73,112,0.348214285714286
"3941",54,100,70,68,138,0.507246376811594
"3942",54,101,16,28,44,0.363636363636364
"3943",54,102,33,26,59,0.559322033898305
"3944",54,103,5,3,8,0.625
"3945",54,104,51,79,130,0.392307692307692
"3946",54,105,18,17,35,0.514285714285714
"3947",54,106,52,54,106,0.490566037735849
"3948",54,107,24,25,49,0.489795918367347
"3949",54,109,10,9,19,0.526315789473684
"3950",54,110,30,26,56,0.535714285714286
"3951",54,111,9,12,21,0.428571428571429
"3952",54,112,66,58,124,0.532258064516129
"3953",54,55,40,25,65,0.615384615384615
"3954",54,56,17,24,41,0.414634146341463
"3955",54,57,53,49,102,0.519607843137255
"3956",54,58,7,10,17,0.411764705882353
"3957",54,59,23,32,55,0.418181818181818
"3958",54,60,28,19,47,0.595744680851064
"3959",54,61,9,13,22,0.409090909090909
"3960",54,62,55,80,135,0.407407407407407
"3961",54,63,25,25,50,0.5
"3962",54,64,26,29,55,0.472727272727273
"3963",54,65,10,6,16,0.625
"3964",54,67,34,40,74,0.459459459459459
"3965",54,68,64,54,118,0.542372881355932
"3966",54,69,49,55,104,0.471153846153846
"3967",54,70,35,30,65,0.538461538461538
"3968",54,71,101,83,184,0.548913043478261
"3969",54,72,43,58,101,0.425742574257426
"3970",54,73,79,93,172,0.459302325581395
"3971",54,74,119,128,247,0.481781376518219
"3972",54,75,74,73,147,0.503401360544218
"3973",54,76,12,20,32,0.375
"3974",54,77,6,7,13,0.461538461538462
"3975",54,78,5,8,13,0.384615384615385
"3976",54,79,6,14,20,0.3
"3977",54,80,8,7,15,0.533333333333333
"3978",54,81,9,23,32,0.28125
"3979",54,82,11,15,26,0.423076923076923
"3980",54,83,13,13,26,0.5
"3981",54,84,36,46,82,0.439024390243902
"3982",54,85,52,47,99,0.525252525252525
"3983",54,86,67,80,147,0.45578231292517
"3984",54,87,48,47,95,0.505263157894737
"3985",54,88,26,25,51,0.509803921568627
"3986",54,89,4,8,12,0.333333333333333
"3987",54,90,20,24,44,0.454545454545455
"3988",54,91,9,11,20,0.45
"3989",54,92,7,13,20,0.35
"3990",54,93,44,83,127,0.346456692913386
"3991",54,94,24,17,41,0.585365853658537
"3992",54,95,10,10,20,0.5
"3993",54,96,18,16,34,0.529411764705882
"3994",54,97,24,30,54,0.444444444444444
"3995",54,98,22,28,50,0.44
"3996",54,99,37,42,79,0.468354430379747
"3997",55,100,131,98,229,0.572052401746725
"3998",55,101,37,49,86,0.430232558139535
"3999",55,102,48,33,81,0.592592592592593
"4000",55,103,6,7,13,0.461538461538462
"4001",55,104,116,130,246,0.471544715447154
"4002",55,105,9,12,21,0.428571428571429
"4003",55,106,148,132,280,0.528571428571429
"4004",55,107,34,23,57,0.596491228070175
"4005",55,109,25,27,52,0.480769230769231
"4006",55,110,22,20,42,0.523809523809524
"4007",55,111,24,16,40,0.6
"4008",55,112,205,195,400,0.5125
"4009",55,56,39,25,64,0.609375
"4010",55,57,68,47,115,0.591304347826087
"4011",55,58,7,14,21,0.333333333333333
"4012",55,59,61,46,107,0.570093457943925
"4013",55,60,37,33,70,0.528571428571429
"4014",55,61,4,10,14,0.285714285714286
"4015",55,62,131,124,255,0.513725490196078
"4016",55,63,25,29,54,0.462962962962963
"4017",55,64,42,39,81,0.518518518518518
"4018",55,65,13,6,19,0.684210526315789
"4019",55,66,10,6,16,0.625
"4020",55,67,117,96,213,0.549295774647887
"4021",55,68,114,115,229,0.497816593886463
"4022",55,69,83,71,154,0.538961038961039
"4023",55,70,57,52,109,0.522935779816514
"4024",55,71,146,98,244,0.598360655737705
"4025",55,72,167,174,341,0.489736070381232
"4026",55,73,178,153,331,0.537764350453172
"4027",55,74,166,155,321,0.517133956386293
"4028",55,75,100,102,202,0.495049504950495
"4029",55,76,19,26,45,0.422222222222222
"4030",55,77,20,14,34,0.588235294117647
"4031",55,78,7,11,18,0.388888888888889
"4032",55,79,18,19,37,0.486486486486487
"4033",55,80,5,16,21,0.238095238095238
"4034",55,81,28,29,57,0.491228070175439
"4035",55,82,27,19,46,0.58695652173913
"4036",55,83,26,14,40,0.65
"4037",55,84,56,58,114,0.491228070175439
"4038",55,85,45,53,98,0.459183673469388
"4039",55,86,113,146,259,0.436293436293436
"4040",55,87,101,105,206,0.490291262135922
"4041",55,88,23,23,46,0.5
"4042",55,89,12,23,35,0.342857142857143
"4043",55,90,29,22,51,0.568627450980392
"4044",55,91,21,37,58,0.362068965517241
"4045",55,92,23,21,44,0.522727272727273
"4046",55,93,132,131,263,0.501901140684411
"4047",55,94,37,41,78,0.474358974358974
"4048",55,95,23,25,48,0.479166666666667
"4049",55,96,10,9,19,0.526315789473684
"4050",55,97,30,39,69,0.434782608695652
"4051",55,98,17,15,32,0.53125
"4052",55,99,29,40,69,0.420289855072464
"4053",56,100,97,95,192,0.505208333333333
"4054",56,101,20,36,56,0.357142857142857
"4055",56,102,34,30,64,0.53125
"4056",56,103,6,9,15,0.4
"4057",56,104,80,97,177,0.451977401129944
"4058",56,105,8,14,22,0.363636363636364
"4059",56,106,54,52,106,0.509433962264151
"4060",56,107,26,29,55,0.472727272727273
"4061",56,109,13,16,29,0.448275862068966
"4062",56,110,28,24,52,0.538461538461538
"4063",56,111,4,8,12,0.333333333333333
"4064",56,112,75,61,136,0.551470588235294
"4065",56,57,50,48,98,0.510204081632653
"4066",56,58,9,8,17,0.529411764705882
"4067",56,59,26,33,59,0.440677966101695
"4068",56,60,26,23,49,0.530612244897959
"4069",56,61,8,15,23,0.347826086956522
"4070",56,62,47,52,99,0.474747474747475
"4071",56,63,5,13,18,0.277777777777778
"4072",56,64,26,19,45,0.577777777777778
"4073",56,65,11,16,27,0.407407407407407
"4074",56,66,9,5,14,0.642857142857143
"4075",56,67,54,35,89,0.606741573033708
"4076",56,68,62,73,135,0.459259259259259
"4077",56,69,59,75,134,0.440298507462687
"4078",56,70,45,23,68,0.661764705882353
"4079",56,71,56,63,119,0.470588235294118
"4080",56,72,32,33,65,0.492307692307692
"4081",56,73,88,84,172,0.511627906976744
"4082",56,74,95,110,205,0.463414634146341
"4083",56,75,58,60,118,0.491525423728814
"4084",56,76,15,19,34,0.441176470588235
"4085",56,77,10,9,19,0.526315789473684
"4086",56,78,7,10,17,0.411764705882353
"4087",56,79,10,15,25,0.4
"4088",56,80,6,9,15,0.4
"4089",56,81,11,13,24,0.458333333333333
"4090",56,82,11,17,28,0.392857142857143
"4091",56,83,28,28,56,0.5
"4092",56,84,57,62,119,0.478991596638655
"4093",56,85,65,57,122,0.532786885245902
"4094",56,86,75,83,158,0.474683544303797
"4095",56,87,44,47,91,0.483516483516484
"4096",56,88,14,21,35,0.4
"4097",56,89,12,7,19,0.631578947368421
"4098",56,90,15,25,40,0.375
"4099",56,91,8,17,25,0.32
"4100",56,92,7,8,15,0.466666666666667
"4101",56,93,33,56,89,0.370786516853933
"4102",56,94,16,17,33,0.484848484848485
"4103",56,95,13,12,25,0.52
"4104",56,96,19,15,34,0.558823529411765
"4105",56,97,21,33,54,0.388888888888889
"4106",56,98,20,25,45,0.444444444444444
"4107",56,99,25,32,57,0.43859649122807
"4108",57,100,199,147,346,0.57514450867052
"4109",57,101,38,34,72,0.527777777777778
"4110",57,102,66,41,107,0.616822429906542
"4111",57,103,15,7,22,0.681818181818182
"4112",57,104,229,167,396,0.578282828282828
"4113",57,105,23,8,31,0.741935483870968
"4114",57,106,161,123,284,0.566901408450704
"4115",57,107,45,23,68,0.661764705882353
"4116",57,109,39,29,68,0.573529411764706
"4117",57,110,37,27,64,0.578125
"4118",57,111,15,11,26,0.576923076923077
"4119",57,112,88,54,142,0.619718309859155
"4120",57,58,22,14,36,0.611111111111111
"4121",57,59,118,70,188,0.627659574468085
"4122",57,60,50,34,84,0.595238095238095
"4123",57,61,23,27,50,0.46
"4124",57,62,103,91,194,0.530927835051546
"4125",57,63,59,47,106,0.556603773584906
"4126",57,64,52,23,75,0.693333333333333
"4127",57,65,26,20,46,0.565217391304348
"4128",57,66,7,5,12,0.583333333333333
"4129",57,67,173,100,273,0.633699633699634
"4130",57,68,64,57,121,0.528925619834711
"4131",57,69,141,97,238,0.592436974789916
"4132",57,70,127,59,186,0.682795698924731
"4133",57,71,157,77,234,0.670940170940171
"4134",57,72,164,118,282,0.581560283687943
"4135",57,73,267,158,425,0.628235294117647
"4136",57,74,264,208,472,0.559322033898305
"4137",57,75,127,79,206,0.616504854368932
"4138",57,76,35,31,66,0.53030303030303
"4139",57,77,31,13,44,0.704545454545455
"4140",57,78,19,14,33,0.575757575757576
"4141",57,79,20,17,37,0.540540540540541
"4142",57,80,17,14,31,0.548387096774194
"4143",57,81,57,36,93,0.612903225806452
"4144",57,82,42,38,80,0.525
"4145",57,83,24,13,37,0.648648648648649
"4146",57,84,51,38,89,0.573033707865168
"4147",57,85,106,44,150,0.706666666666667
"4148",57,86,98,90,188,0.521276595744681
"4149",57,87,64,43,107,0.598130841121495
"4150",57,88,65,29,94,0.691489361702128
"4151",57,89,11,13,24,0.458333333333333
"4152",57,90,26,27,53,0.490566037735849
"4153",57,91,19,11,30,0.633333333333333
"4154",57,92,16,11,27,0.592592592592593
"4155",57,93,204,142,346,0.589595375722543
"4156",57,94,62,47,109,0.568807339449541
"4157",57,95,43,49,92,0.467391304347826
"4158",57,96,51,28,79,0.645569620253165
"4159",57,97,72,58,130,0.553846153846154
"4160",57,98,62,49,111,0.558558558558559
"4161",57,99,97,77,174,0.557471264367816
"4162",58,100,15,37,52,0.288461538461538
"4163",58,101,11,15,26,0.423076923076923
"4164",58,102,13,18,31,0.419354838709677
"4165",58,104,18,32,50,0.36
"4166",58,105,3,5,8,0.375
"4167",58,106,34,38,72,0.472222222222222
"4168",58,107,10,10,20,0.5
"4169",58,109,4,10,14,0.285714285714286
"4170",58,110,14,7,21,0.666666666666667
"4171",58,111,2,6,8,0.25
"4172",58,112,19,21,40,0.475
"4173",58,59,12,19,31,0.387096774193548
"4174",58,60,6,19,25,0.24
"4175",58,61,4,6,10,0.4
"4176",58,62,13,18,31,0.419354838709677
"4177",58,63,7,9,16,0.4375
"4178",58,64,9,4,13,0.692307692307692
"4179",58,65,4,6,10,0.4
"4180",58,67,34,23,57,0.596491228070175
"4181",58,68,19,25,44,0.431818181818182
"4182",58,69,22,25,47,0.468085106382979
"4183",58,70,8,15,23,0.347826086956522
"4184",58,71,15,35,50,0.3
"4185",58,72,16,35,51,0.313725490196078
"4186",58,73,29,43,72,0.402777777777778
"4187",58,74,33,42,75,0.44
"4188",58,75,20,28,48,0.416666666666667
"4189",58,76,6,6,12,0.5
"4190",58,77,3,3,6,0.5
"4191",58,79,2,5,7,0.285714285714286
"4192",58,81,9,9,18,0.5
"4193",58,82,3,9,12,0.25
"4194",58,84,13,21,34,0.382352941176471
"4195",58,85,15,15,30,0.5
"4196",58,86,28,47,75,0.373333333333333
"4197",58,87,16,5,21,0.761904761904762
"4198",58,88,9,7,16,0.5625
"4199",58,90,5,14,19,0.263157894736842
"4200",58,91,7,3,10,0.7
"4201",58,92,4,3,7,0.571428571428571
"4202",58,93,29,44,73,0.397260273972603
"4203",58,94,9,11,20,0.45
"4204",58,95,10,7,17,0.588235294117647
"4205",58,96,8,7,15,0.533333333333333
"4206",58,97,10,20,30,0.333333333333333
"4207",58,98,8,17,25,0.32
"4208",58,99,8,19,27,0.296296296296296
"4209",59,100,139,132,271,0.512915129151292
"4210",59,101,30,49,79,0.379746835443038
"4211",59,102,62,37,99,0.626262626262626
"4212",59,103,10,13,23,0.434782608695652
"4213",59,104,100,133,233,0.429184549356223
"4214",59,105,18,20,38,0.473684210526316
"4215",59,106,66,90,156,0.423076923076923
"4216",59,107,30,25,55,0.545454545454545
"4217",59,109,10,13,23,0.434782608695652
"4218",59,110,47,42,89,0.528089887640449
"4219",59,111,27,27,54,0.5
"4220",59,112,120,94,214,0.560747663551402
"4221",59,60,42,31,73,0.575342465753425
"4222",59,61,13,25,38,0.342105263157895
"4223",59,62,86,96,182,0.472527472527473
"4224",59,63,22,40,62,0.354838709677419
"4225",59,64,28,37,65,0.430769230769231
"4226",59,65,10,15,25,0.4
"4227",59,66,16,7,23,0.695652173913043
"4228",59,67,67,71,138,0.485507246376812
"4229",59,68,83,78,161,0.515527950310559
"4230",59,69,78,72,150,0.52
"4231",59,70,42,44,86,0.488372093023256
"4232",59,71,115,78,193,0.595854922279793
"4233",59,72,71,62,133,0.533834586466165
"4234",59,73,132,117,249,0.530120481927711
"4235",59,74,116,120,236,0.491525423728814
"4236",59,75,107,102,209,0.511961722488038
"4237",59,76,19,20,39,0.487179487179487
"4238",59,77,15,13,28,0.535714285714286
"4239",59,78,6,14,20,0.3
"4240",59,79,13,27,40,0.325
"4241",59,80,8,15,23,0.347826086956522
"4242",59,81,19,25,44,0.431818181818182
"4243",59,82,22,25,47,0.468085106382979
"4244",59,83,26,30,56,0.464285714285714
"4245",59,84,57,67,124,0.459677419354839
"4246",59,85,82,78,160,0.5125
"4247",59,86,89,115,204,0.436274509803922
"4248",59,87,59,61,120,0.491666666666667
"4249",59,88,31,39,70,0.442857142857143
"4250",59,89,9,16,25,0.36
"4251",59,90,29,28,57,0.508771929824561
"4252",59,91,31,32,63,0.492063492063492
"4253",59,92,16,13,29,0.551724137931034
"4254",59,93,74,77,151,0.490066225165563
"4255",59,94,29,32,61,0.475409836065574
"4256",59,95,24,28,52,0.461538461538462
"4257",59,96,22,29,51,0.431372549019608
"4258",59,97,30,25,55,0.545454545454545
"4259",59,98,26,28,54,0.481481481481481
"4260",59,99,44,52,96,0.458333333333333
"4261",6,10,15,16,31,0.483870967741935
"4262",6,100,84,68,152,0.552631578947368
"4263",6,101,12,34,46,0.260869565217391
"4264",6,102,45,32,77,0.584415584415584
"4265",6,103,8,6,14,0.571428571428571
"4266",6,104,66,88,154,0.428571428571429
"4267",6,105,14,14,28,0.5
"4268",6,106,35,37,72,0.486111111111111
"4269",6,107,17,20,37,0.459459459459459
"4270",6,109,11,14,25,0.44
"4271",6,11,144,124,268,0.537313432835821
"4272",6,110,29,24,53,0.547169811320755
"4273",6,111,7,16,23,0.304347826086957
"4274",6,112,79,52,131,0.603053435114504
"4275",6,12,11,21,32,0.34375
"4276",6,13,17,18,35,0.485714285714286
"4277",6,14,76,107,183,0.415300546448087
"4278",6,15,21,19,40,0.525
"4279",6,16,28,37,65,0.430769230769231
"4280",6,17,20,21,41,0.48780487804878
"4281",6,18,23,24,47,0.48936170212766
"4282",6,19,36,46,82,0.439024390243902
"4283",6,20,104,80,184,0.565217391304348
"4284",6,21,281,219,500,0.562
"4285",6,22,41,42,83,0.493975903614458
"4286",6,23,22,17,39,0.564102564102564
"4287",6,25,74,97,171,0.432748538011696
"4288",6,26,66,64,130,0.507692307692308
"4289",6,27,48,42,90,0.533333333333333
"4290",6,28,90,63,153,0.588235294117647
"4291",6,29,27,36,63,0.428571428571429
"4292",6,30,59,75,134,0.440298507462687
"4293",6,31,43,25,68,0.632352941176471
"4294",6,32,47,27,74,0.635135135135135
"4295",6,33,32,29,61,0.524590163934426
"4296",6,34,22,26,48,0.458333333333333
"4297",6,35,40,35,75,0.533333333333333
"4298",6,36,86,52,138,0.623188405797101
"4299",6,37,29,22,51,0.568627450980392
"4300",6,38,14,12,26,0.538461538461538
"4301",6,39,84,91,175,0.48
"4302",6,40,40,20,60,0.666666666666667
"4303",6,41,13,25,38,0.342105263157895
"4304",6,42,54,39,93,0.580645161290323
"4305",6,43,22,14,36,0.611111111111111
"4306",6,44,42,54,96,0.4375
"4307",6,45,16,12,28,0.571428571428571
"4308",6,46,65,58,123,0.528455284552846
"4309",6,47,56,31,87,0.64367816091954
"4310",6,48,26,29,55,0.472727272727273
"4311",6,49,29,25,54,0.537037037037037
"4312",6,50,85,61,146,0.582191780821918
"4313",6,51,34,28,62,0.548387096774194
"4314",6,52,7,13,20,0.35
"4315",6,53,52,49,101,0.514851485148515
"4316",6,54,28,25,53,0.528301886792453
"4317",6,55,24,22,46,0.521739130434783
"4318",6,56,24,28,52,0.461538461538462
"4319",6,57,84,51,135,0.622222222222222
"4320",6,58,13,11,24,0.541666666666667
"4321",6,59,44,40,84,0.523809523809524
"4322",6,60,32,33,65,0.492307692307692
"4323",6,61,10,11,21,0.476190476190476
"4324",6,62,53,60,113,0.469026548672566
"4325",6,63,34,17,51,0.666666666666667
"4326",6,64,35,25,60,0.583333333333333
"4327",6,65,8,5,13,0.615384615384615
"4328",6,66,7,9,16,0.4375
"4329",6,67,28,24,52,0.538461538461538
"4330",6,68,53,62,115,0.460869565217391
"4331",6,69,51,46,97,0.525773195876289
"4332",6,7,132,104,236,0.559322033898305
"4333",6,70,42,32,74,0.567567567567568
"4334",6,71,54,67,121,0.446280991735537
"4335",6,72,51,39,90,0.566666666666667
"4336",6,73,65,75,140,0.464285714285714
"4337",6,74,99,102,201,0.492537313432836
"4338",6,75,68,49,117,0.581196581196581
"4339",6,76,13,22,35,0.371428571428571
"4340",6,77,8,8,16,0.5
"4341",6,78,5,9,14,0.357142857142857
"4342",6,79,9,19,28,0.321428571428571
"4343",6,8,51,45,96,0.53125
"4344",6,80,9,10,19,0.473684210526316
"4345",6,81,18,16,34,0.529411764705882
"4346",6,82,10,17,27,0.37037037037037
"4347",6,83,24,18,42,0.571428571428571
"4348",6,84,62,35,97,0.639175257731959
"4349",6,85,79,57,136,0.580882352941177
"4350",6,86,65,71,136,0.477941176470588
"4351",6,87,40,27,67,0.597014925373134
"4352",6,88,19,29,48,0.395833333333333
"4353",6,89,6,9,15,0.4
"4354",6,9,69,72,141,0.48936170212766
"4355",6,90,23,19,42,0.547619047619048
"4356",6,91,11,12,23,0.478260869565217
"4357",6,92,41,36,77,0.532467532467532
"4358",6,93,45,42,87,0.517241379310345
"4359",6,94,27,14,41,0.658536585365854
"4360",6,95,17,16,33,0.515151515151515
"4361",6,96,23,28,51,0.450980392156863
"4362",6,97,16,23,39,0.41025641025641
"4363",6,98,18,20,38,0.473684210526316
"4364",6,99,41,37,78,0.525641025641026
"4365",60,100,83,100,183,0.453551912568306
"4366",60,101,41,40,81,0.506172839506173
"4367",60,102,35,23,58,0.603448275862069
"4368",60,103,5,5,10,0.5
"4369",60,104,70,86,156,0.448717948717949
"4370",60,105,13,13,26,0.5
"4371",60,106,72,89,161,0.447204968944099
"4372",60,107,27,20,47,0.574468085106383
"4373",60,109,24,15,39,0.615384615384615
"4374",60,110,33,27,60,0.55
"4375",60,111,12,7,19,0.631578947368421
"4376",60,112,93,79,172,0.540697674418605
"4377",60,61,9,8,17,0.529411764705882
"4378",60,62,63,71,134,0.470149253731343
"4379",60,63,20,32,52,0.384615384615385
"4380",60,64,36,32,68,0.529411764705882
"4381",60,65,6,10,16,0.375
"4382",60,66,7,5,12,0.583333333333333
"4383",60,67,75,54,129,0.581395348837209
"4384",60,68,85,80,165,0.515151515151515
"4385",60,69,74,59,133,0.556390977443609
"4386",60,70,46,31,77,0.597402597402597
"4387",60,71,63,67,130,0.484615384615385
"4388",60,72,92,89,181,0.50828729281768
"4389",60,73,126,83,209,0.602870813397129
"4390",60,74,120,108,228,0.526315789473684
"4391",60,75,84,63,147,0.571428571428571
"4392",60,76,18,17,35,0.514285714285714
"4393",60,77,11,13,24,0.458333333333333
"4394",60,78,9,7,16,0.5625
"4395",60,79,14,18,32,0.4375
"4396",60,80,9,12,21,0.428571428571429
"4397",60,81,11,25,36,0.305555555555556
"4398",60,82,16,18,34,0.470588235294118
"4399",60,83,21,18,39,0.538461538461538
"4400",60,84,37,47,84,0.44047619047619
"4401",60,85,55,49,104,0.528846153846154
"4402",60,86,79,101,180,0.438888888888889
"4403",60,87,57,66,123,0.463414634146341
"4404",60,88,30,19,49,0.612244897959184
"4405",60,89,12,12,24,0.5
"4406",60,90,22,29,51,0.431372549019608
"4407",60,91,9,16,25,0.36
"4408",60,92,12,12,24,0.5
"4409",60,93,86,97,183,0.469945355191257
"4410",60,94,31,22,53,0.584905660377358
"4411",60,95,17,21,38,0.447368421052632
"4412",60,96,11,13,24,0.458333333333333
"4413",60,97,22,29,51,0.431372549019608
"4414",60,98,11,28,39,0.282051282051282
"4415",60,99,29,39,68,0.426470588235294
"4416",61,100,29,51,80,0.3625
"4417",61,101,11,19,30,0.366666666666667
"4418",61,102,15,17,32,0.46875
"4419",61,103,3,3,6,0.5
"4420",61,104,42,67,109,0.385321100917431
"4421",61,105,5,5,10,0.5
"4422",61,106,39,52,91,0.428571428571429
"4423",61,107,10,14,24,0.416666666666667
"4424",61,109,7,8,15,0.466666666666667
"4425",61,110,6,7,13,0.461538461538462
"4426",61,112,35,36,71,0.492957746478873
"4427",61,62,16,44,60,0.266666666666667
"4428",61,63,8,14,22,0.363636363636364
"4429",61,64,15,11,26,0.576923076923077
"4430",61,66,3,6,9,0.333333333333333
"4431",61,67,33,31,64,0.515625
"4432",61,68,30,36,66,0.454545454545455
"4433",61,69,40,32,72,0.555555555555556
"4434",61,70,30,25,55,0.545454545454545
"4435",61,71,22,25,47,0.468085106382979
"4436",61,72,26,49,75,0.346666666666667
"4437",61,73,41,64,105,0.39047619047619
"4438",61,74,49,85,134,0.365671641791045
"4439",61,75,30,39,69,0.434782608695652
"4440",61,76,13,10,23,0.565217391304348
"4441",61,77,8,9,17,0.470588235294118
"4442",61,78,4,4,8,0.5
"4443",61,79,4,13,17,0.235294117647059
"4444",61,81,9,9,18,0.5
"4445",61,82,7,7,14,0.5
"4446",61,83,5,13,18,0.277777777777778
"4447",61,84,22,24,46,0.478260869565217
"4448",61,85,12,15,27,0.444444444444444
"4449",61,86,41,68,109,0.376146788990826
"4450",61,87,28,28,56,0.5
"4451",61,88,10,17,27,0.37037037037037
"4452",61,90,10,19,29,0.344827586206897
"4453",61,91,7,7,14,0.5
"4454",61,92,5,10,15,0.333333333333333
"4455",61,93,32,55,87,0.367816091954023
"4456",61,94,8,15,23,0.347826086956522
"4457",61,95,6,10,16,0.375
"4458",61,96,7,5,12,0.583333333333333
"4459",61,97,11,12,23,0.478260869565217
"4460",61,99,4,16,20,0.2
"4461",62,100,186,204,390,0.476923076923077
"4462",62,101,53,81,134,0.395522388059701
"4463",62,102,84,56,140,0.6
"4464",62,103,26,8,34,0.764705882352941
"4465",62,104,174,222,396,0.439393939393939
"4466",62,105,9,19,28,0.321428571428571
"4467",62,106,201,221,422,0.476303317535545
"4468",62,107,70,64,134,0.522388059701492
"4469",62,109,49,42,91,0.538461538461538
"4470",62,110,94,66,160,0.5875
"4471",62,111,29,21,50,0.58
"4472",62,112,180,163,343,0.524781341107872
"4473",62,63,39,72,111,0.351351351351351
"4474",62,64,45,48,93,0.483870967741935
"4475",62,65,19,25,44,0.431818181818182
"4476",62,66,3,5,8,0.375
"4477",62,67,247,144,391,0.631713554987212
"4478",62,68,125,133,258,0.484496124031008
"4479",62,69,187,159,346,0.540462427745665
"4480",62,70,88,81,169,0.520710059171598
"4481",62,71,156,154,310,0.503225806451613
"4482",62,72,176,187,363,0.484848484848485
"4483",62,73,292,262,554,0.527075812274368
"4484",62,74,342,322,664,0.515060240963855
"4485",62,75,171,177,348,0.491379310344828
"4486",62,76,39,41,80,0.4875
"4487",62,77,24,16,40,0.6
"4488",62,78,26,18,44,0.590909090909091
"4489",62,79,21,34,55,0.381818181818182
"4490",62,80,17,23,40,0.425
"4491",62,81,44,58,102,0.431372549019608
"4492",62,82,40,42,82,0.48780487804878
"4493",62,83,28,38,66,0.424242424242424
"4494",62,84,75,73,148,0.506756756756757
"4495",62,85,98,91,189,0.518518518518518
"4496",62,86,153,190,343,0.446064139941691
"4497",62,87,99,99,198,0.5
"4498",62,88,40,50,90,0.444444444444444
"4499",62,89,20,19,39,0.512820512820513
"4500",62,90,43,41,84,0.511904761904762
"4501",62,91,28,27,55,0.509090909090909
"4502",62,92,17,19,36,0.472222222222222
"4503",62,93,214,245,459,0.466230936819172
"4504",62,94,67,55,122,0.549180327868853
"4505",62,95,46,42,88,0.522727272727273
"4506",62,96,47,44,91,0.516483516483517
"4507",62,97,77,90,167,0.461077844311377
"4508",62,98,68,69,137,0.496350364963504
"4509",62,99,103,113,216,0.476851851851852
"4510",63,100,66,94,160,0.4125
"4511",63,101,17,33,50,0.34
"4512",63,102,49,34,83,0.590361445783133
"4513",63,103,11,6,17,0.647058823529412
"4514",63,104,80,104,184,0.434782608695652
"4515",63,105,8,13,21,0.380952380952381
"4516",63,106,49,65,114,0.429824561403509
"4517",63,107,20,24,44,0.454545454545455
"4518",63,109,13,11,24,0.541666666666667
"4519",63,110,19,15,34,0.558823529411765
"4520",63,111,10,11,21,0.476190476190476
"4521",63,112,58,65,123,0.471544715447154
"4522",63,64,19,37,56,0.339285714285714
"4523",63,65,7,16,23,0.304347826086957
"4524",63,66,5,7,12,0.416666666666667
"4525",63,67,44,33,77,0.571428571428571
"4526",63,68,54,77,131,0.412213740458015
"4527",63,69,49,57,106,0.462264150943396
"4528",63,70,36,34,70,0.514285714285714
"4529",63,71,66,61,127,0.519685039370079
"4530",63,72,44,51,95,0.463157894736842
"4531",63,73,121,83,204,0.593137254901961
"4532",63,74,76,120,196,0.387755102040816
"4533",63,75,67,79,146,0.458904109589041
"4534",63,76,13,15,28,0.464285714285714
"4535",63,77,7,9,16,0.4375
"4536",63,78,6,6,12,0.5
"4537",63,79,5,16,21,0.238095238095238
"4538",63,80,4,9,13,0.307692307692308
"4539",63,81,27,29,56,0.482142857142857
"4540",63,82,9,14,23,0.391304347826087
"4541",63,83,18,21,39,0.461538461538462
"4542",63,84,48,54,102,0.470588235294118
"4543",63,85,60,60,120,0.5
"4544",63,86,61,107,168,0.363095238095238
"4545",63,87,39,50,89,0.438202247191011
"4546",63,88,12,23,35,0.342857142857143
"4547",63,89,6,14,20,0.3
"4548",63,90,19,26,45,0.422222222222222
"4549",63,91,15,23,38,0.394736842105263
"4550",63,92,7,8,15,0.466666666666667
"4551",63,93,50,64,114,0.43859649122807
"4552",63,94,15,26,41,0.365853658536585
"4553",63,95,12,16,28,0.428571428571429
"4554",63,96,14,9,23,0.608695652173913
"4555",63,97,16,27,43,0.372093023255814
"4556",63,98,14,18,32,0.4375
"4557",63,99,20,37,57,0.350877192982456
"4558",64,100,100,70,170,0.588235294117647
"4559",64,101,20,26,46,0.434782608695652
"4560",64,102,35,23,58,0.603448275862069
"4561",64,103,5,6,11,0.454545454545455
"4562",64,104,90,86,176,0.511363636363636
"4563",64,105,4,5,9,0.444444444444444
"4564",64,106,93,96,189,0.492063492063492
"4565",64,107,21,21,42,0.5
"4566",64,109,21,12,33,0.636363636363636
"4567",64,110,36,26,62,0.580645161290323
"4568",64,112,45,33,78,0.576923076923077
"4569",64,65,10,17,27,0.37037037037037
"4570",64,66,7,6,13,0.538461538461538
"4571",64,67,89,56,145,0.613793103448276
"4572",64,68,39,32,71,0.549295774647887
"4573",64,69,84,61,145,0.579310344827586
"4574",64,70,43,26,69,0.623188405797101
"4575",64,71,73,66,139,0.525179856115108
"4576",64,72,87,76,163,0.533742331288344
"4577",64,73,107,116,223,0.479820627802691
"4578",64,74,129,123,252,0.511904761904762
"4579",64,75,58,44,102,0.568627450980392
"4580",64,76,22,26,48,0.458333333333333
"4581",64,77,12,18,30,0.4
"4582",64,78,14,14,28,0.5
"4583",64,79,12,10,22,0.545454545454545
"4584",64,80,15,7,22,0.681818181818182
"4585",64,81,16,25,41,0.390243902439024
"4586",64,82,14,17,31,0.451612903225806
"4587",64,83,15,9,24,0.625
"4588",64,84,35,34,69,0.507246376811594
"4589",64,85,72,57,129,0.558139534883721
"4590",64,86,45,54,99,0.454545454545455
"4591",64,87,24,39,63,0.380952380952381
"4592",64,88,34,23,57,0.596491228070175
"4593",64,89,14,9,23,0.608695652173913
"4594",64,90,13,16,29,0.448275862068966
"4595",64,91,9,13,22,0.409090909090909
"4596",64,92,7,6,13,0.538461538461538
"4597",64,93,97,103,200,0.485
"4598",64,94,19,24,43,0.441860465116279
"4599",64,95,24,26,50,0.48
"4600",64,96,22,22,44,0.5
"4601",64,97,39,53,92,0.423913043478261
"4602",64,98,20,41,61,0.327868852459016
"4603",64,99,53,46,99,0.535353535353535
"4604",65,100,34,37,71,0.47887323943662
"4605",65,101,7,15,22,0.318181818181818
"4606",65,102,14,15,29,0.482758620689655
"4607",65,104,19,42,61,0.311475409836066
"4608",65,105,7,4,11,0.636363636363636
"4609",65,106,38,35,73,0.520547945205479
"4610",65,109,9,5,14,0.642857142857143
"4611",65,110,13,11,24,0.541666666666667
"4612",65,112,22,35,57,0.385964912280702
"4613",65,67,27,18,45,0.6
"4614",65,68,20,25,45,0.444444444444444
"4615",65,69,18,28,46,0.391304347826087
"4616",65,70,17,20,37,0.459459459459459
"4617",65,71,20,21,41,0.48780487804878
"4618",65,72,14,27,41,0.341463414634146
"4619",65,73,34,38,72,0.472222222222222
"4620",65,74,40,59,99,0.404040404040404
"4621",65,75,21,22,43,0.488372093023256
"4622",65,77,4,3,7,0.571428571428571
"4623",65,79,2,12,14,0.142857142857143
"4624",65,80,6,7,13,0.461538461538462
"4625",65,81,10,7,17,0.588235294117647
"4626",65,83,5,4,9,0.555555555555556
"4627",65,84,17,15,32,0.53125
"4628",65,85,20,16,36,0.555555555555556
"4629",65,86,25,51,76,0.328947368421053
"4630",65,87,25,16,41,0.609756097560976
"4631",65,88,12,10,22,0.545454545454545
"4632",65,89,7,5,12,0.583333333333333
"4633",65,90,7,5,12,0.583333333333333
"4634",65,91,2,11,13,0.153846153846154
"4635",65,92,5,8,13,0.384615384615385
"4636",65,93,32,38,70,0.457142857142857
"4637",65,94,18,20,38,0.473684210526316
"4638",65,95,8,9,17,0.470588235294118
"4639",65,96,6,4,10,0.6
"4640",65,97,6,8,14,0.428571428571429
"4641",65,98,2,10,12,0.166666666666667
"4642",65,99,8,15,23,0.347826086956522
"4643",66,100,20,10,30,0.666666666666667
"4644",66,102,9,8,17,0.529411764705882
"4645",66,104,11,17,28,0.392857142857143
"4646",66,106,14,17,31,0.451612903225806
"4647",66,107,6,5,11,0.545454545454545
"4648",66,109,5,8,13,0.384615384615385
"4649",66,110,11,8,19,0.578947368421053
"4650",66,112,11,12,23,0.478260869565217
"4651",66,67,14,11,25,0.56
"4652",66,68,7,8,15,0.466666666666667
"4653",66,69,15,10,25,0.6
"4654",66,70,12,8,20,0.6
"4655",66,71,19,12,31,0.612903225806452
"4656",66,72,16,20,36,0.444444444444444
"4657",66,73,22,22,44,0.5
"4658",66,74,26,26,52,0.5
"4659",66,75,11,9,20,0.55
"4660",66,78,2,4,6,0.333333333333333
"4661",66,80,3,4,7,0.428571428571429
"4662",66,81,8,7,15,0.533333333333333
"4663",66,82,5,2,7,0.714285714285714
"4664",66,84,7,8,15,0.466666666666667
"4665",66,85,11,8,19,0.578947368421053
"4666",66,86,10,18,28,0.357142857142857
"4667",66,87,9,9,18,0.5
"4668",66,90,2,4,6,0.333333333333333
"4669",66,93,15,21,36,0.416666666666667
"4670",66,97,5,8,13,0.384615384615385
"4671",66,98,8,7,15,0.533333333333333
"4672",66,99,6,8,14,0.428571428571429
"4673",67,100,369,209,578,0.63840830449827
"4674",67,101,86,85,171,0.502923976608187
"4675",67,102,90,57,147,0.612244897959184
"4676",67,103,27,21,48,0.5625
"4677",67,104,183,132,315,0.580952380952381
"4678",67,105,37,29,66,0.560606060606061
"4679",67,106,164,113,277,0.592057761732852
"4680",67,107,84,76,160,0.525
"4681",67,109,12,12,24,0.5
"4682",67,110,109,65,174,0.626436781609195
"4683",67,111,36,23,59,0.610169491525424
"4684",67,112,306,190,496,0.616935483870968
"4685",67,68,250,173,423,0.591016548463357
"4686",67,69,256,152,408,0.627450980392157
"4687",67,70,60,44,104,0.576923076923077
"4688",67,71,245,157,402,0.609452736318408
"4689",67,72,63,30,93,0.67741935483871
"4690",67,73,196,113,309,0.634304207119741
"4691",67,74,373,290,663,0.562594268476621
"4692",67,75,271,166,437,0.620137299771167
"4693",67,76,38,39,77,0.493506493506494
"4694",67,77,13,10,23,0.565217391304348
"4695",67,78,18,16,34,0.529411764705882
"4696",67,79,44,37,81,0.54320987654321
"4697",67,80,21,14,35,0.6
"4698",67,81,26,16,42,0.619047619047619
"4699",67,82,38,29,67,0.567164179104478
"4700",67,83,55,41,96,0.572916666666667
"4701",67,84,145,84,229,0.633187772925764
"4702",67,85,208,132,340,0.611764705882353
"4703",67,86,251,243,494,0.508097165991903
"4704",67,87,159,111,270,0.588888888888889
"4705",67,88,90,79,169,0.532544378698225
"4706",67,89,10,14,24,0.416666666666667
"4707",67,90,73,46,119,0.613445378151261
"4708",67,91,41,32,73,0.561643835616438
"4709",67,92,28,29,57,0.491228070175439
"4710",67,93,69,50,119,0.579831932773109
"4711",67,94,23,15,38,0.605263157894737
"4712",67,95,18,12,30,0.6
"4713",67,96,67,37,104,0.644230769230769
"4714",67,97,84,82,166,0.506024096385542
"4715",67,98,85,68,153,0.555555555555556
"4716",67,99,120,96,216,0.555555555555556
"4717",68,100,259,281,540,0.47962962962963
"4718",68,101,29,50,79,0.367088607594937
"4719",68,102,76,55,131,0.580152671755725
"4720",68,103,15,24,39,0.384615384615385
"4721",68,104,209,241,450,0.464444444444444
"4722",68,105,14,26,40,0.35
"4723",68,106,201,238,439,0.457858769931663
"4724",68,107,62,64,126,0.492063492063492
"4725",68,109,42,34,76,0.552631578947368
"4726",68,110,70,76,146,0.479452054794521
"4727",68,111,17,13,30,0.566666666666667
"4728",68,112,101,99,200,0.505
"4729",68,69,218,205,423,0.515366430260047
"4730",68,70,100,91,191,0.523560209424084
"4731",68,71,202,158,360,0.561111111111111
"4732",68,72,183,215,398,0.459798994974874
"4733",68,73,299,264,563,0.531083481349911
"4734",68,74,308,316,624,0.493589743589744
"4735",68,75,129,112,241,0.535269709543568
"4736",68,76,33,48,81,0.407407407407407
"4737",68,77,21,27,48,0.4375
"4738",68,78,26,27,53,0.490566037735849
"4739",68,79,8,22,30,0.266666666666667
"4740",68,80,20,25,45,0.444444444444444
"4741",68,81,82,70,152,0.539473684210526
"4742",68,82,33,35,68,0.485294117647059
"4743",68,83,31,31,62,0.5
"4744",68,84,71,85,156,0.455128205128205
"4745",68,85,143,106,249,0.57429718875502
"4746",68,86,105,142,247,0.425101214574899
"4747",68,87,51,52,103,0.495145631067961
"4748",68,88,63,70,133,0.473684210526316
"4749",68,89,23,21,44,0.522727272727273
"4750",68,90,18,36,54,0.333333333333333
"4751",68,91,27,32,59,0.457627118644068
"4752",68,92,6,22,28,0.214285714285714
"4753",68,93,254,257,511,0.49706457925636
"4754",68,94,54,62,116,0.46551724137931
"4755",68,95,40,55,95,0.421052631578947
"4756",68,96,62,51,113,0.548672566371681
"4757",68,97,95,129,224,0.424107142857143
"4758",68,98,75,88,163,0.460122699386503
"4759",68,99,111,97,208,0.533653846153846
"4760",69,100,298,235,533,0.559099437148218
"4761",69,101,91,110,201,0.45273631840796
"4762",69,102,90,61,151,0.596026490066225
"4763",69,103,20,25,45,0.444444444444444
"4764",69,104,172,144,316,0.544303797468354
"4765",69,105,31,24,55,0.563636363636364
"4766",69,106,276,268,544,0.507352941176471
"4767",69,107,104,80,184,0.565217391304348
"4768",69,109,51,33,84,0.607142857142857
"4769",69,110,70,50,120,0.583333333333333
"4770",69,111,26,27,53,0.490566037735849
"4771",69,112,331,245,576,0.574652777777778
"4772",69,70,114,81,195,0.584615384615385
"4773",69,71,201,145,346,0.580924855491329
"4774",69,72,231,209,440,0.525
"4775",69,73,334,235,569,0.586994727592267
"4776",69,74,407,310,717,0.567642956764296
"4777",69,75,250,193,443,0.564334085778781
"4778",69,76,51,29,80,0.6375
"4779",69,77,21,19,40,0.525
"4780",69,78,18,14,32,0.5625
"4781",69,79,34,55,89,0.382022471910112
"4782",69,80,24,20,44,0.545454545454545
"4783",69,81,56,49,105,0.533333333333333
"4784",69,82,59,40,99,0.595959595959596
"4785",69,83,54,43,97,0.556701030927835
"4786",69,84,130,77,207,0.628019323671498
"4787",69,85,137,115,252,0.543650793650794
"4788",69,86,276,304,580,0.475862068965517
"4789",69,87,162,137,299,0.54180602006689
"4790",69,88,59,56,115,0.51304347826087
"4791",69,89,19,21,40,0.475
"4792",69,90,66,55,121,0.545454545454545
"4793",69,91,51,50,101,0.504950495049505
"4794",69,92,30,27,57,0.526315789473684
"4795",69,93,269,243,512,0.525390625
"4796",69,94,65,61,126,0.515873015873016
"4797",69,95,39,39,78,0.5
"4798",69,96,17,24,41,0.414634146341463
"4799",69,97,67,73,140,0.478571428571429
"4800",69,98,36,54,90,0.4
"4801",69,99,64,60,124,0.516129032258065
"4802",7,10,66,68,134,0.492537313432836
"4803",7,100,347,297,644,0.538819875776398
"4804",7,101,67,118,185,0.362162162162162
"4805",7,102,122,87,209,0.583732057416268
"4806",7,103,33,27,60,0.55
"4807",7,104,313,317,630,0.496825396825397
"4808",7,105,30,30,60,0.5
"4809",7,106,365,381,746,0.489276139410188
"4810",7,107,103,87,190,0.542105263157895
"4811",7,109,62,61,123,0.504065040650406
"4812",7,11,909,822,1731,0.525129982668977
"4813",7,110,122,106,228,0.535087719298246
"4814",7,111,24,34,58,0.413793103448276
"4815",7,112,286,295,581,0.492254733218589
"4816",7,12,198,251,449,0.44097995545657
"4817",7,13,63,94,157,0.401273885350318
"4818",7,14,330,302,632,0.522151898734177
"4819",7,15,90,86,176,0.511363636363636
"4820",7,16,71,86,157,0.452229299363057
"4821",7,17,86,129,215,0.4
"4822",7,18,153,141,294,0.520408163265306
"4823",7,19,222,227,449,0.494432071269488
"4824",7,20,154,124,278,0.553956834532374
"4825",7,21,941,982,1923,0.489339573582943
"4826",7,22,233,173,406,0.573891625615764
"4827",7,23,87,103,190,0.457894736842105
"4828",7,25,282,375,657,0.429223744292237
"4829",7,26,176,211,387,0.454780361757106
"4830",7,27,114,93,207,0.550724637681159
"4831",7,28,455,367,822,0.55352798053528
"4832",7,29,95,72,167,0.568862275449102
"4833",7,30,223,213,436,0.511467889908257
"4834",7,31,177,136,313,0.565495207667732
"4835",7,32,168,132,300,0.56
"4836",7,33,87,106,193,0.450777202072539
"4837",7,34,100,108,208,0.480769230769231
"4838",7,35,154,175,329,0.468085106382979
"4839",7,36,242,165,407,0.594594594594595
"4840",7,37,54,45,99,0.545454545454545
"4841",7,38,48,34,82,0.585365853658537
"4842",7,39,476,547,1023,0.465298142717498
"4843",7,40,101,98,199,0.507537688442211
"4844",7,41,101,131,232,0.435344827586207
"4845",7,42,363,282,645,0.562790697674419
"4846",7,43,67,67,134,0.5
"4847",7,44,275,313,588,0.467687074829932
"4848",7,45,42,51,93,0.451612903225806
"4849",7,46,313,291,604,0.518211920529801
"4850",7,47,168,145,313,0.536741214057508
"4851",7,48,129,107,236,0.546610169491525
"4852",7,49,85,65,150,0.566666666666667
"4853",7,50,310,274,584,0.530821917808219
"4854",7,51,168,173,341,0.49266862170088
"4855",7,52,40,41,81,0.493827160493827
"4856",7,53,90,124,214,0.420560747663551
"4857",7,54,100,106,206,0.485436893203884
"4858",7,55,201,161,362,0.55524861878453
"4859",7,56,117,126,243,0.481481481481481
"4860",7,57,185,107,292,0.633561643835616
"4861",7,58,18,37,55,0.327272727272727
"4862",7,59,146,158,304,0.480263157894737
"4863",7,60,112,107,219,0.511415525114155
"4864",7,61,55,81,136,0.404411764705882
"4865",7,62,203,204,407,0.498771498771499
"4866",7,63,99,110,209,0.473684210526316
"4867",7,64,88,73,161,0.546583850931677
"4868",7,65,31,43,74,0.418918918918919
"4869",7,66,17,16,33,0.515151515151515
"4870",7,67,362,256,618,0.585760517799353
"4871",7,68,250,238,488,0.512295081967213
"4872",7,69,340,305,645,0.527131782945736
"4873",7,70,201,136,337,0.596439169139466
"4874",7,71,244,203,447,0.54586129753915
"4875",7,72,405,342,747,0.542168674698795
"4876",7,73,438,401,839,0.522050059594756
"4877",7,74,472,549,1021,0.462291870714985
"4878",7,75,287,241,528,0.543560606060606
"4879",7,76,71,65,136,0.522058823529412
"4880",7,77,32,35,67,0.477611940298507
"4881",7,78,35,38,73,0.479452054794521
"4882",7,79,37,52,89,0.415730337078652
"4883",7,8,486,415,901,0.539400665926748
"4884",7,80,28,38,66,0.424242424242424
"4885",7,81,93,109,202,0.46039603960396
"4886",7,82,101,104,205,0.492682926829268
"4887",7,83,50,29,79,0.632911392405063
"4888",7,84,91,97,188,0.484042553191489
"4889",7,85,212,146,358,0.592178770949721
"4890",7,86,241,284,525,0.459047619047619
"4891",7,87,184,152,336,0.547619047619048
"4892",7,88,95,98,193,0.492227979274611
"4893",7,89,28,42,70,0.4
"4894",7,9,278,227,505,0.550495049504951
"4895",7,90,65,74,139,0.467625899280576
"4896",7,91,47,55,102,0.46078431372549
"4897",7,92,26,22,48,0.541666666666667
"4898",7,93,342,365,707,0.483734087694484
"4899",7,94,120,116,236,0.508474576271186
"4900",7,95,80,87,167,0.479041916167665
"4901",7,96,60,46,106,0.566037735849057
"4902",7,97,154,183,337,0.456973293768546
"4903",7,98,114,117,231,0.493506493506494
"4904",7,99,148,176,324,0.45679012345679
"4905",70,100,160,136,296,0.540540540540541
"4906",70,101,34,53,87,0.390804597701149
"4907",70,102,61,35,96,0.635416666666667
"4908",70,103,14,8,22,0.636363636363636
"4909",70,104,131,106,237,0.552742616033755
"4910",70,105,20,12,32,0.625
"4911",70,106,112,102,214,0.523364485981308
"4912",70,107,51,40,91,0.56043956043956
"4913",70,109,20,16,36,0.555555555555556
"4914",70,110,52,37,89,0.584269662921348
"4915",70,111,27,14,41,0.658536585365854
"4916",70,112,139,87,226,0.615044247787611
"4917",70,71,120,68,188,0.638297872340426
"4918",70,72,75,57,132,0.568181818181818
"4919",70,73,155,117,272,0.569852941176471
"4920",70,74,215,192,407,0.528255528255528
"4921",70,75,131,87,218,0.600917431192661
"4922",70,76,35,24,59,0.593220338983051
"4923",70,77,9,7,16,0.5625
"4924",70,78,24,14,38,0.631578947368421
"4925",70,79,20,20,40,0.5
"4926",70,80,14,15,29,0.482758620689655
"4927",70,81,30,14,44,0.681818181818182
"4928",70,82,13,20,33,0.393939393939394
"4929",70,83,35,13,48,0.729166666666667
"4930",70,84,94,55,149,0.630872483221476
"4931",70,85,107,62,169,0.633136094674556
"4932",70,86,133,101,234,0.568376068376068
"4933",70,87,83,42,125,0.664
"4934",70,88,31,34,65,0.476923076923077
"4935",70,89,20,9,29,0.689655172413793
"4936",70,90,52,28,80,0.65
"4937",70,91,44,42,86,0.511627906976744
"4938",70,92,16,11,27,0.592592592592593
"4939",70,93,120,89,209,0.574162679425837
"4940",70,94,42,21,63,0.666666666666667
"4941",70,95,23,15,38,0.605263157894737
"4942",70,96,34,22,56,0.607142857142857
"4943",70,97,51,45,96,0.53125
"4944",70,98,55,53,108,0.509259259259259
"4945",70,99,52,45,97,0.536082474226804
"4946",71,100,211,177,388,0.543814432989691
"4947",71,101,73,80,153,0.477124183006536
"4948",71,102,88,55,143,0.615384615384615
"4949",71,103,20,18,38,0.526315789473684
"4950",71,104,206,175,381,0.540682414698163
"4951",71,105,21,30,51,0.411764705882353
"4952",71,106,243,195,438,0.554794520547945
"4953",71,107,74,44,118,0.627118644067797
"4954",71,109,46,30,76,0.605263157894737
"4955",71,110,79,65,144,0.548611111111111
"4956",71,111,16,29,45,0.355555555555556
"4957",71,112,230,183,413,0.556900726392252
"4958",71,72,228,173,401,0.56857855361596
"4959",71,73,316,210,526,0.600760456273764
"4960",71,74,370,319,689,0.537010159651669
"4961",71,75,238,171,409,0.581907090464548
"4962",71,76,40,36,76,0.526315789473684
"4963",71,77,41,25,66,0.621212121212121
"4964",71,78,16,21,37,0.432432432432432
"4965",71,79,21,37,58,0.362068965517241
"4966",71,80,10,27,37,0.27027027027027
"4967",71,81,41,59,100,0.41
"4968",71,82,39,42,81,0.481481481481481
"4969",71,83,31,34,65,0.476923076923077
"4970",71,84,101,74,175,0.577142857142857
"4971",71,85,180,104,284,0.633802816901408
"4972",71,86,208,227,435,0.47816091954023
"4973",71,87,136,116,252,0.53968253968254
"4974",71,88,54,61,115,0.469565217391304
"4975",71,89,14,17,31,0.451612903225806
"4976",71,90,45,57,102,0.441176470588235
"4977",71,91,45,46,91,0.494505494505495
"4978",71,92,31,21,52,0.596153846153846
"4979",71,93,240,223,463,0.518358531317495
"4980",71,94,73,49,122,0.598360655737705
"4981",71,95,55,49,104,0.528846153846154
"4982",71,96,33,27,60,0.55
"4983",71,97,51,71,122,0.418032786885246
"4984",71,98,60,59,119,0.504201680672269
"4985",71,99,68,72,140,0.485714285714286
"4986",72,100,339,316,655,0.517557251908397
"4987",72,101,70,83,153,0.457516339869281
"4988",72,102,103,82,185,0.556756756756757
"4989",72,103,29,21,50,0.58
"4990",72,104,199,198,397,0.501259445843829
"4991",72,105,22,35,57,0.385964912280702
"4992",72,106,145,146,291,0.498281786941581
"4993",72,107,91,81,172,0.529069767441861
"4994",72,109,15,19,34,0.441176470588235
"4995",72,110,78,97,175,0.445714285714286
"4996",72,111,21,25,46,0.456521739130435
"4997",72,112,276,264,540,0.511111111111111
"4998",72,73,292,242,534,0.546816479400749
"4999",72,74,295,296,591,0.499153976311337
"5000",72,75,202,162,364,0.554945054945055
"5001",72,76,29,37,66,0.439393939393939
"5002",72,77,16,19,35,0.457142857142857
"5003",72,78,26,21,47,0.553191489361702
"5004",72,79,29,56,85,0.341176470588235
"5005",72,80,16,17,33,0.484848484848485
"5006",72,81,21,25,46,0.456521739130435
"5007",72,82,34,27,61,0.557377049180328
"5008",72,83,58,48,106,0.547169811320755
"5009",72,84,141,126,267,0.528089887640449
"5010",72,85,210,173,383,0.548302872062663
"5011",72,86,223,283,506,0.440711462450593
"5012",72,87,153,150,303,0.504950495049505
"5013",72,88,81,83,164,0.49390243902439
"5014",72,89,25,27,52,0.480769230769231
"5015",72,90,47,58,105,0.447619047619048
"5016",72,91,37,49,86,0.430232558139535
"5017",72,92,27,22,49,0.551020408163265
"5018",72,93,78,95,173,0.450867052023121
"5019",72,94,26,20,46,0.565217391304348
"5020",72,95,18,20,38,0.473684210526316
"5021",72,96,50,42,92,0.543478260869565
"5022",72,97,86,114,200,0.43
"5023",72,98,62,84,146,0.424657534246575
"5024",72,99,100,109,209,0.478468899521531
"5025",73,100,439,361,800,0.54875
"5026",73,101,101,108,209,0.483253588516746
"5027",73,102,135,107,242,0.557851239669422
"5028",73,103,29,32,61,0.475409836065574
"5029",73,104,292,338,630,0.463492063492064
"5030",73,105,43,46,89,0.48314606741573
"5031",73,106,167,185,352,0.474431818181818
"5032",73,107,121,97,218,0.555045871559633
"5033",73,109,46,35,81,0.567901234567901
"5034",73,110,133,105,238,0.558823529411765
"5035",73,111,52,48,100,0.52
"5036",73,112,326,279,605,0.538842975206612
"5037",73,74,272,301,573,0.474694589877836
"5038",73,75,312,237,549,0.568306010928962
"5039",73,76,25,35,60,0.416666666666667
"5040",73,77,31,27,58,0.53448275862069
"5041",73,78,28,31,59,0.474576271186441
"5042",73,79,49,73,122,0.401639344262295
"5043",73,80,27,39,66,0.409090909090909
"5044",73,81,67,65,132,0.507575757575758
"5045",73,82,45,54,99,0.454545454545455
"5046",73,83,80,79,159,0.50314465408805
"5047",73,84,178,174,352,0.505681818181818
"5048",73,85,268,181,449,0.596881959910913
"5049",73,86,344,356,700,0.491428571428571
"5050",73,87,197,138,335,0.588059701492537
"5051",73,88,134,87,221,0.606334841628959
"5052",73,89,21,24,45,0.466666666666667
"5053",73,90,95,102,197,0.482233502538071
"5054",73,91,48,60,108,0.444444444444444
"5055",73,92,48,33,81,0.592592592592593
"5056",73,93,268,265,533,0.50281425891182
"5057",73,94,69,55,124,0.556451612903226
"5058",73,95,50,64,114,0.43859649122807
"5059",73,96,70,61,131,0.534351145038168
"5060",73,97,91,101,192,0.473958333333333
"5061",73,98,98,123,221,0.443438914027149
"5062",73,99,142,151,293,0.484641638225256
"5063",74,100,476,436,912,0.521929824561403
"5064",74,101,112,135,247,0.453441295546559
"5065",74,102,163,151,314,0.519108280254777
"5066",74,103,30,35,65,0.461538461538462
"5067",74,104,419,500,919,0.455930359085963
"5068",74,105,47,57,104,0.451923076923077
"5069",74,106,206,257,463,0.444924406047516
"5070",74,107,127,107,234,0.542735042735043
"5071",74,109,67,59,126,0.531746031746032
"5072",74,110,132,132,264,0.5
"5073",74,111,37,40,77,0.480519480519481
"5074",74,112,348,326,674,0.516320474777448
"5075",74,75,309,284,593,0.521079258010118
"5076",74,76,18,34,52,0.346153846153846
"5077",74,77,34,39,73,0.465753424657534
"5078",74,78,37,34,71,0.52112676056338
"5079",74,79,53,80,133,0.398496240601504
"5080",74,80,39,43,82,0.475609756097561
"5081",74,81,109,103,212,0.514150943396226
"5082",74,82,51,64,115,0.443478260869565
"5083",74,83,84,79,163,0.515337423312883
"5084",74,84,214,184,398,0.537688442211055
"5085",74,85,312,244,556,0.561151079136691
"5086",74,86,334,441,775,0.430967741935484
"5087",74,87,237,202,439,0.539863325740319
"5088",74,88,104,129,233,0.446351931330472
"5089",74,89,38,40,78,0.487179487179487
"5090",74,90,84,99,183,0.459016393442623
"5091",74,91,60,73,133,0.451127819548872
"5092",74,92,46,48,94,0.48936170212766
"5093",74,93,401,401,802,0.5
"5094",74,94,107,85,192,0.557291666666667
"5095",74,95,90,91,181,0.497237569060773
"5096",74,96,78,72,150,0.52
"5097",74,97,103,147,250,0.412
"5098",74,98,85,122,207,0.410628019323671
"5099",74,99,153,193,346,0.442196531791907
"5100",75,100,301,254,555,0.542342342342342
"5101",75,101,53,65,118,0.449152542372881
"5102",75,102,100,61,161,0.62111801242236
"5103",75,103,16,14,30,0.533333333333333
"5104",75,104,274,266,540,0.507407407407407
"5105",75,105,29,16,45,0.644444444444444
"5106",75,106,203,190,393,0.516539440203562
"5107",75,107,94,66,160,0.5875
"5108",75,109,36,39,75,0.48
"5109",75,110,70,55,125,0.56
"5110",75,111,17,18,35,0.485714285714286
"5111",75,112,140,129,269,0.520446096654275
"5112",75,76,35,37,72,0.486111111111111
"5113",75,77,24,38,62,0.387096774193548
"5114",75,78,33,19,52,0.634615384615385
"5115",75,79,19,34,53,0.358490566037736
"5116",75,80,22,22,44,0.5
"5117",75,81,73,58,131,0.557251908396947
"5118",75,82,52,39,91,0.571428571428571
"5119",75,83,36,31,67,0.537313432835821
"5120",75,84,128,103,231,0.554112554112554
"5121",75,85,177,100,277,0.63898916967509
"5122",75,86,147,187,334,0.440119760479042
"5123",75,87,82,78,160,0.5125
"5124",75,88,67,74,141,0.475177304964539
"5125",75,89,21,22,43,0.488372093023256
"5126",75,90,33,48,81,0.407407407407407
"5127",75,91,30,33,63,0.476190476190476
"5128",75,92,17,19,36,0.472222222222222
"5129",75,93,275,250,525,0.523809523809524
"5130",75,94,63,67,130,0.484615384615385
"5131",75,95,61,48,109,0.559633027522936
"5132",75,96,82,55,137,0.598540145985402
"5133",75,97,87,98,185,0.47027027027027
"5134",75,98,81,71,152,0.532894736842105
"5135",75,99,104,115,219,0.474885844748858
"5136",76,100,56,47,103,0.543689320388349
"5137",76,101,11,21,32,0.34375
"5138",76,102,23,16,39,0.58974358974359
"5139",76,104,56,66,122,0.459016393442623
"5140",76,105,5,6,11,0.454545454545455
"5141",76,106,24,31,55,0.436363636363636
"5142",76,107,13,13,26,0.5
"5143",76,109,9,8,17,0.529411764705882
"5144",76,110,14,17,31,0.451612903225806
"5145",76,111,7,7,14,0.5
"5146",76,112,39,50,89,0.438202247191011
"5147",76,77,11,7,18,0.611111111111111
"5148",76,78,6,3,9,0.666666666666667
"5149",76,79,9,13,22,0.409090909090909
"5150",76,80,4,4,8,0.5
"5151",76,81,9,13,22,0.409090909090909
"5152",76,82,8,7,15,0.533333333333333
"5153",76,83,14,13,27,0.518518518518518
"5154",76,84,33,28,61,0.540983606557377
"5155",76,85,32,41,73,0.438356164383562
"5156",76,86,39,55,94,0.414893617021277
"5157",76,87,23,25,48,0.479166666666667
"5158",76,88,12,18,30,0.4
"5159",76,89,10,12,22,0.454545454545455
"5160",76,90,13,15,28,0.464285714285714
"5161",76,91,4,9,13,0.307692307692308
"5162",76,92,4,8,12,0.333333333333333
"5163",76,93,36,51,87,0.413793103448276
"5164",76,94,12,16,28,0.428571428571429
"5165",76,95,11,13,24,0.458333333333333
"5166",76,96,11,10,21,0.523809523809524
"5167",76,97,9,23,32,0.28125
"5168",76,98,9,19,28,0.321428571428571
"5169",76,99,23,29,52,0.442307692307692
"5170",77,100,29,28,57,0.508771929824561
"5171",77,101,13,15,28,0.464285714285714
"5172",77,102,9,7,16,0.5625
"5173",77,104,17,30,47,0.361702127659574
"5174",77,105,2,5,7,0.285714285714286
"5175",77,106,26,23,49,0.530612244897959
"5176",77,107,4,12,16,0.25
"5177",77,109,9,5,14,0.642857142857143
"5178",77,110,11,9,20,0.55
"5179",77,112,27,22,49,0.551020408163265
"5180",77,79,3,7,10,0.3
"5181",77,80,7,4,11,0.636363636363636
"5182",77,81,7,9,16,0.4375
"5183",77,82,5,7,12,0.416666666666667
"5184",77,83,5,3,8,0.625
"5185",77,84,20,16,36,0.555555555555556
"5186",77,85,18,20,38,0.473684210526316
"5187",77,86,16,34,50,0.32
"5188",77,87,11,9,20,0.55
"5189",77,88,9,8,17,0.529411764705882
"5190",77,89,3,3,6,0.5
"5191",77,90,8,7,15,0.533333333333333
"5192",77,92,6,4,10,0.6
"5193",77,93,18,26,44,0.409090909090909
"5194",77,94,5,5,10,0.5
"5195",77,95,3,6,9,0.333333333333333
"5196",77,97,18,15,33,0.545454545454545
"5197",77,98,12,10,22,0.545454545454545
"5198",77,99,9,13,22,0.409090909090909
"5199",78,100,26,35,61,0.426229508196721
"5200",78,101,14,9,23,0.608695652173913
"5201",78,102,9,12,21,0.428571428571429
"5202",78,104,35,31,66,0.53030303030303
"5203",78,106,23,20,43,0.534883720930233
"5204",78,107,9,5,14,0.642857142857143
"5205",78,109,8,11,19,0.421052631578947
"5206",78,110,4,10,14,0.285714285714286
"5207",78,112,37,25,62,0.596774193548387
"5208",78,79,9,11,20,0.45
"5209",78,80,4,2,6,0.666666666666667
"5210",78,81,5,5,10,0.5
"5211",78,83,7,2,9,0.777777777777778
"5212",78,84,16,16,32,0.5
"5213",78,85,16,18,34,0.470588235294118
"5214",78,86,38,44,82,0.463414634146341
"5215",78,87,18,17,35,0.514285714285714
"5216",78,88,9,11,20,0.45
"5217",78,89,6,6,12,0.5
"5218",78,90,8,14,22,0.363636363636364
"5219",78,91,5,8,13,0.384615384615385
"5220",78,93,33,26,59,0.559322033898305
"5221",78,94,7,6,13,0.538461538461538
"5222",78,95,3,7,10,0.3
"5223",78,96,8,6,14,0.571428571428571
"5224",78,98,6,9,15,0.4
"5225",79,100,32,45,77,0.415584415584416
"5226",79,102,13,22,35,0.371428571428571
"5227",79,103,3,6,9,0.333333333333333
"5228",79,104,29,45,74,0.391891891891892
"5229",79,106,40,60,100,0.4
"5230",79,107,12,19,31,0.387096774193548
"5231",79,109,6,11,17,0.352941176470588
"5232",79,110,8,21,29,0.275862068965517
"5233",79,112,17,26,43,0.395348837209302
"5234",79,80,2,2,4,0.5
"5235",79,81,13,18,31,0.419354838709677
"5236",79,82,7,11,18,0.388888888888889
"5237",79,83,4,5,9,0.444444444444444
"5238",79,84,11,13,24,0.458333333333333
"5239",79,85,27,27,54,0.5
"5240",79,86,19,24,43,0.441860465116279
"5241",79,87,8,14,22,0.363636363636364
"5242",79,88,14,15,29,0.482758620689655
"5243",79,90,5,7,12,0.416666666666667
"5244",79,92,5,2,7,0.714285714285714
"5245",79,93,32,48,80,0.4
"5246",79,94,7,12,19,0.368421052631579
"5247",79,95,5,10,15,0.333333333333333
"5248",79,96,12,11,23,0.521739130434783
"5249",79,97,18,21,39,0.461538461538462
"5250",79,98,9,21,30,0.3
"5251",79,99,8,17,25,0.32
"5252",8,10,27,50,77,0.350649350649351
"5253",8,100,448,430,878,0.510250569476082
"5254",8,101,118,135,253,0.466403162055336
"5255",8,102,155,93,248,0.625
"5256",8,103,34,24,58,0.586206896551724
"5257",8,104,255,296,551,0.462794918330309
"5258",8,105,44,49,93,0.473118279569892
"5259",8,106,210,187,397,0.52896725440806
"5260",8,107,150,114,264,0.568181818181818
"5261",8,109,29,30,59,0.491525423728814
"5262",8,11,785,697,1482,0.529689608636977
"5263",8,110,144,123,267,0.539325842696629
"5264",8,111,47,37,84,0.55952380952381
"5265",8,112,384,316,700,0.548571428571429
"5266",8,12,31,33,64,0.484375
"5267",8,13,50,80,130,0.384615384615385
"5268",8,14,390,397,787,0.495552731893266
"5269",8,15,70,60,130,0.538461538461538
"5270",8,16,114,135,249,0.457831325301205
"5271",8,17,67,104,171,0.391812865497076
"5272",8,18,52,60,112,0.464285714285714
"5273",8,19,163,148,311,0.52411575562701
"5274",8,20,181,157,338,0.535502958579882
"5275",8,21,793,894,1687,0.470065204505039
"5276",8,22,262,167,429,0.610722610722611
"5277",8,23,96,70,166,0.578313253012048
"5278",8,25,335,403,738,0.453929539295393
"5279",8,26,354,349,703,0.503556187766714
"5280",8,27,207,181,388,0.533505154639175
"5281",8,28,473,337,810,0.583950617283951
"5282",8,29,116,105,221,0.524886877828054
"5283",8,30,309,318,627,0.492822966507177
"5284",8,31,247,184,431,0.573085846867749
"5285",8,32,156,118,274,0.569343065693431
"5286",8,33,113,100,213,0.530516431924883
"5287",8,34,119,113,232,0.512931034482759
"5288",8,35,94,111,205,0.458536585365854
"5289",8,36,260,206,466,0.55793991416309
"5290",8,37,95,64,159,0.59748427672956
"5291",8,38,56,45,101,0.554455445544555
"5292",8,39,417,496,913,0.456736035049288
"5293",8,40,143,104,247,0.578947368421053
"5294",8,41,36,69,105,0.342857142857143
"5295",8,42,157,94,251,0.625498007968127
"5296",8,43,73,53,126,0.579365079365079
"5297",8,44,78,135,213,0.366197183098592
"5298",8,45,54,53,107,0.504672897196262
"5299",8,46,252,221,473,0.53276955602537
"5300",8,47,139,138,277,0.501805054151625
"5301",8,48,36,34,70,0.514285714285714
"5302",8,49,63,54,117,0.538461538461538
"5303",8,50,347,330,677,0.512555391432792
"5304",8,51,202,192,394,0.512690355329949
"5305",8,52,45,53,98,0.459183673469388
"5306",8,53,96,148,244,0.39344262295082
"5307",8,54,63,76,139,0.453237410071942
"5308",8,55,188,142,330,0.56969696969697
"5309",8,56,52,65,117,0.444444444444444
"5310",8,57,197,146,343,0.574344023323615
"5311",8,58,23,43,66,0.348484848484849
"5312",8,59,108,116,224,0.482142857142857
"5313",8,60,149,107,256,0.58203125
"5314",8,61,52,58,110,0.472727272727273
"5315",8,62,280,284,564,0.49645390070922
"5316",8,63,65,89,154,0.422077922077922
"5317",8,64,127,114,241,0.526970954356846
"5318",8,65,50,64,114,0.43859649122807
"5319",8,66,24,21,45,0.533333333333333
"5320",8,67,74,55,129,0.573643410852713
"5321",8,68,330,267,597,0.552763819095477
"5322",8,69,365,296,661,0.552193645990923
"5323",8,70,120,101,221,0.542986425339366
"5324",8,71,368,266,634,0.580441640378549
"5325",8,72,82,85,167,0.491017964071856
"5326",8,73,390,325,715,0.545454545454545
"5327",8,74,459,455,914,0.50218818380744
"5328",8,75,309,278,587,0.526405451448041
"5329",8,76,50,62,112,0.446428571428571
"5330",8,77,22,26,48,0.458333333333333
"5331",8,78,40,34,74,0.540540540540541
"5332",8,79,52,57,109,0.477064220183486
"5333",8,80,39,27,66,0.590909090909091
"5334",8,81,39,45,84,0.464285714285714
"5335",8,82,50,42,92,0.543478260869565
"5336",8,83,75,65,140,0.535714285714286
"5337",8,84,197,178,375,0.525333333333333
"5338",8,85,285,207,492,0.579268292682927
"5339",8,86,375,413,788,0.475888324873096
"5340",8,87,221,190,411,0.537712895377129
"5341",8,88,101,113,214,0.47196261682243
"5342",8,89,29,31,60,0.483333333333333
"5343",8,9,310,269,579,0.535405872193437
"5344",8,90,77,74,151,0.509933774834437
"5345",8,91,52,60,112,0.464285714285714
"5346",8,92,42,34,76,0.552631578947368
"5347",8,93,120,140,260,0.461538461538462
"5348",8,94,46,53,99,0.464646464646465
"5349",8,95,19,40,59,0.322033898305085
"5350",8,96,84,72,156,0.538461538461538
"5351",8,97,170,145,315,0.53968253968254
"5352",8,98,104,111,215,0.483720930232558
"5353",8,99,145,154,299,0.48494983277592
"5354",80,100,24,27,51,0.470588235294118
"5355",80,101,8,12,20,0.4
"5356",80,102,9,11,20,0.45
"5357",80,104,21,32,53,0.39622641509434
"5358",80,105,3,5,8,0.375
"5359",80,106,29,35,64,0.453125
"5360",80,107,6,12,18,0.333333333333333
"5361",80,110,10,13,23,0.434782608695652
"5362",80,111,5,8,13,0.384615384615385
"5363",80,112,24,32,56,0.428571428571429
"5364",80,81,7,8,15,0.466666666666667
"5365",80,82,5,7,12,0.416666666666667
"5366",80,83,4,6,10,0.4
"5367",80,84,21,19,40,0.525
"5368",80,85,13,16,29,0.448275862068966
"5369",80,86,27,35,62,0.435483870967742
"5370",80,87,15,21,36,0.416666666666667
"5371",80,88,7,10,17,0.411764705882353
"5372",80,89,6,4,10,0.6
"5373",80,90,9,12,21,0.428571428571429
"5374",80,91,5,9,14,0.357142857142857
"5375",80,93,14,30,44,0.318181818181818
"5376",80,94,10,7,17,0.588235294117647
"5377",80,95,6,10,16,0.375
"5378",80,96,6,7,13,0.461538461538462
"5379",80,97,4,8,12,0.333333333333333
"5380",80,98,8,8,16,0.5
"5381",80,99,9,17,26,0.346153846153846
"5382",81,100,81,76,157,0.515923566878981
"5383",81,101,20,31,51,0.392156862745098
"5384",81,102,28,21,49,0.571428571428571
"5385",81,103,5,11,16,0.3125
"5386",81,104,54,72,126,0.428571428571429
"5387",81,105,7,7,14,0.5
"5388",81,106,31,39,70,0.442857142857143
"5389",81,107,26,14,40,0.65
"5390",81,109,8,11,19,0.421052631578947
"5391",81,110,27,30,57,0.473684210526316
"5392",81,111,12,6,18,0.666666666666667
"5393",81,112,56,65,121,0.462809917355372
"5394",81,83,10,14,24,0.416666666666667
"5395",81,84,38,36,74,0.513513513513513
"5396",81,85,55,43,98,0.561224489795918
"5397",81,86,62,68,130,0.476923076923077
"5398",81,87,43,43,86,0.5
"5399",81,88,28,20,48,0.583333333333333
"5400",81,89,6,7,13,0.461538461538462
"5401",81,90,26,29,55,0.472727272727273
"5402",81,91,34,59,93,0.365591397849462
"5403",81,92,6,13,19,0.315789473684211
"5404",81,93,38,36,74,0.513513513513513
"5405",81,94,23,7,30,0.766666666666667
"5406",81,95,11,9,20,0.55
"5407",81,96,17,14,31,0.548387096774194
"5408",81,97,27,27,54,0.5
"5409",81,98,20,25,45,0.444444444444444
"5410",81,99,26,45,71,0.366197183098592
"5411",82,100,81,66,147,0.551020408163265
"5412",82,101,24,18,42,0.571428571428571
"5413",82,102,12,17,29,0.413793103448276
"5414",82,103,5,5,10,0.5
"5415",82,104,37,60,97,0.381443298969072
"5416",82,105,5,18,23,0.217391304347826
"5417",82,106,33,43,76,0.434210526315789
"5418",82,107,24,21,45,0.533333333333333
"5419",82,109,6,6,12,0.5
"5420",82,110,26,16,42,0.619047619047619
"5421",82,111,10,8,18,0.555555555555556
"5422",82,112,62,43,105,0.59047619047619
"5423",82,83,14,7,21,0.666666666666667
"5424",82,84,24,39,63,0.380952380952381
"5425",82,85,41,21,62,0.661290322580645
"5426",82,86,46,50,96,0.479166666666667
"5427",82,87,32,36,68,0.470588235294118
"5428",82,88,6,12,18,0.333333333333333
"5429",82,89,4,8,12,0.333333333333333
"5430",82,90,10,20,30,0.333333333333333
"5431",82,91,4,11,15,0.266666666666667
"5432",82,92,7,7,14,0.5
"5433",82,93,25,51,76,0.328947368421053
"5434",82,94,12,15,27,0.444444444444444
"5435",82,95,11,14,25,0.44
"5436",82,96,10,8,18,0.555555555555556
"5437",82,97,13,22,35,0.371428571428571
"5438",82,98,15,16,31,0.483870967741935
"5439",82,99,27,24,51,0.529411764705882
"5440",83,100,63,40,103,0.611650485436893
"5441",83,101,7,12,19,0.368421052631579
"5442",83,102,24,19,43,0.558139534883721
"5443",83,103,7,2,9,0.777777777777778
"5444",83,104,51,51,102,0.5
"5445",83,106,48,47,95,0.505263157894737
"5446",83,107,16,9,25,0.64
"5447",83,109,11,5,16,0.6875
"5448",83,110,24,23,47,0.51063829787234
"5449",83,111,5,7,12,0.416666666666667
"5450",83,112,31,26,57,0.543859649122807
"5451",83,84,17,12,29,0.586206896551724
"5452",83,85,34,17,51,0.666666666666667
"5453",83,86,30,38,68,0.441176470588235
"5454",83,87,17,15,32,0.53125
"5455",83,88,21,8,29,0.724137931034483
"5456",83,89,9,5,14,0.642857142857143
"5457",83,90,7,11,18,0.388888888888889
"5458",83,91,8,11,19,0.421052631578947
"5459",83,92,8,4,12,0.666666666666667
"5460",83,93,61,65,126,0.484126984126984
"5461",83,94,15,14,29,0.517241379310345
"5462",83,95,5,10,15,0.333333333333333
"5463",83,96,13,6,19,0.684210526315789
"5464",83,97,21,26,47,0.446808510638298
"5465",83,98,17,22,39,0.435897435897436
"5466",83,99,28,15,43,0.651162790697674
"5467",84,100,141,136,277,0.509025270758123
"5468",84,101,26,39,65,0.4
"5469",84,102,43,28,71,0.605633802816901
"5470",84,103,11,10,21,0.523809523809524
"5471",84,104,147,139,286,0.513986013986014
"5472",84,105,10,16,26,0.384615384615385
"5473",84,106,108,120,228,0.473684210526316
"5474",84,107,42,36,78,0.538461538461538
"5475",84,109,31,27,58,0.53448275862069
"5476",84,110,47,54,101,0.465346534653465
"5477",84,111,8,7,15,0.533333333333333
"5478",84,112,94,80,174,0.540229885057471
"5479",84,85,76,68,144,0.527777777777778
"5480",84,86,90,76,166,0.542168674698795
"5481",84,87,50,47,97,0.515463917525773
"5482",84,88,45,39,84,0.535714285714286
"5483",84,89,13,12,25,0.52
"5484",84,90,25,25,50,0.5
"5485",84,91,13,19,32,0.40625
"5486",84,92,7,9,16,0.4375
"5487",84,93,139,162,301,0.461794019933555
"5488",84,94,55,58,113,0.486725663716814
"5489",84,95,39,30,69,0.565217391304348
"5490",84,96,38,37,75,0.506666666666667
"5491",84,97,40,47,87,0.459770114942529
"5492",84,98,33,51,84,0.392857142857143
"5493",84,99,63,73,136,0.463235294117647
"5494",85,100,302,216,518,0.583011583011583
"5495",85,101,40,58,98,0.408163265306122
"5496",85,102,64,33,97,0.65979381443299
"5497",85,103,19,8,27,0.703703703703704
"5498",85,104,186,130,316,0.588607594936709
"5499",85,105,12,10,22,0.545454545454545
"5500",85,106,233,161,394,0.591370558375635
"5501",85,107,69,38,107,0.644859813084112
"5502",85,109,48,23,71,0.676056338028169
"5503",85,110,66,37,103,0.640776699029126
"5504",85,111,24,14,38,0.631578947368421
"5505",85,112,213,133,346,0.615606936416185
"5506",85,86,185,148,333,0.555555555555556
"5507",85,87,126,92,218,0.577981651376147
"5508",85,88,34,45,79,0.430379746835443
"5509",85,89,22,19,41,0.536585365853659
"5510",85,90,44,37,81,0.54320987654321
"5511",85,91,27,30,57,0.473684210526316
"5512",85,92,22,15,37,0.594594594594595
"5513",85,93,238,197,435,0.547126436781609
"5514",85,94,86,36,122,0.704918032786885
"5515",85,95,48,42,90,0.533333333333333
"5516",85,96,22,9,31,0.709677419354839
"5517",85,97,74,56,130,0.569230769230769
"5518",85,98,37,39,76,0.486842105263158
"5519",85,99,59,43,102,0.57843137254902
"5520",86,100,309,326,635,0.486614173228346
"5521",86,101,46,78,124,0.370967741935484
"5522",86,102,81,77,158,0.512658227848101
"5523",86,103,24,26,50,0.48
"5524",86,104,204,305,509,0.400785854616896
"5525",86,105,23,29,52,0.442307692307692
"5526",86,106,249,309,558,0.446236559139785
"5527",86,107,72,97,169,0.42603550295858
"5528",86,109,53,60,113,0.469026548672566
"5529",86,110,82,109,191,0.429319371727749
"5530",86,111,15,20,35,0.428571428571429
"5531",86,112,106,150,256,0.4140625
"5532",86,87,78,83,161,0.484472049689441
"5533",86,88,70,91,161,0.434782608695652
"5534",86,89,28,37,65,0.430769230769231
"5535",86,90,32,31,63,0.507936507936508
"5536",86,91,24,58,82,0.292682926829268
"5537",86,92,13,21,34,0.382352941176471
"5538",86,93,261,339,600,0.435
"5539",86,94,68,79,147,0.462585034013605
"5540",86,95,51,60,111,0.459459459459459
"5541",86,96,62,48,110,0.563636363636364
"5542",86,97,95,131,226,0.420353982300885
"5543",86,98,79,120,199,0.396984924623116
"5544",86,99,112,152,264,0.424242424242424
"5545",87,100,181,178,359,0.504178272980501
"5546",87,101,28,31,59,0.474576271186441
"5547",87,102,52,44,96,0.541666666666667
"5548",87,103,14,22,36,0.388888888888889
"5549",87,104,167,140,307,0.543973941368078
"5550",87,105,18,12,30,0.6
"5551",87,106,169,169,338,0.5
"5552",87,107,52,42,94,0.553191489361702
"5553",87,109,29,30,59,0.491525423728814
"5554",87,110,57,60,117,0.487179487179487
"5555",87,111,10,15,25,0.4
"5556",87,112,79,88,167,0.473053892215569
"5557",87,88,44,48,92,0.478260869565217
"5558",87,89,18,18,36,0.5
"5559",87,90,15,14,29,0.517241379310345
"5560",87,91,18,17,35,0.514285714285714
"5561",87,92,16,9,25,0.64
"5562",87,93,169,148,317,0.533123028391167
"5563",87,94,47,47,94,0.5
"5564",87,95,35,23,58,0.603448275862069
"5565",87,96,36,36,72,0.5
"5566",87,97,72,87,159,0.452830188679245
"5567",87,98,44,50,94,0.468085106382979
"5568",87,99,72,76,148,0.486486486486487
"5569",88,100,71,90,161,0.440993788819876
"5570",88,101,26,35,61,0.426229508196721
"5571",88,102,35,24,59,0.593220338983051
"5572",88,103,6,11,17,0.352941176470588
"5573",88,104,81,109,190,0.426315789473684
"5574",88,105,6,18,24,0.25
"5575",88,106,72,95,167,0.431137724550898
"5576",88,107,16,19,35,0.457142857142857
"5577",88,109,22,12,34,0.647058823529412
"5578",88,110,22,17,39,0.564102564102564
"5579",88,111,7,11,18,0.388888888888889
"5580",88,112,72,79,151,0.47682119205298
"5581",88,89,11,9,20,0.55
"5582",88,90,15,29,44,0.340909090909091
"5583",88,91,13,14,27,0.481481481481481
"5584",88,92,10,8,18,0.555555555555556
"5585",88,93,85,89,174,0.488505747126437
"5586",88,94,29,25,54,0.537037037037037
"5587",88,95,11,21,32,0.34375
"5588",88,96,6,10,16,0.375
"5589",88,97,33,33,66,0.5
"5590",88,98,15,21,36,0.416666666666667
"5591",88,99,17,25,42,0.404761904761905
"5592",89,100,28,22,50,0.56
"5593",89,101,11,18,29,0.379310344827586
"5594",89,102,12,12,24,0.5
"5595",89,103,5,3,8,0.625
"5596",89,104,35,28,63,0.555555555555556
"5597",89,106,12,21,33,0.363636363636364
"5598",89,107,5,18,23,0.217391304347826
"5599",89,109,4,5,9,0.444444444444444
"5600",89,110,11,17,28,0.392857142857143
"5601",89,111,4,5,9,0.444444444444444
"5602",89,112,20,37,57,0.350877192982456
"5603",89,90,9,16,25,0.36
"5604",89,91,2,10,12,0.166666666666667
"5605",89,93,21,16,37,0.567567567567568
"5606",89,96,5,8,13,0.384615384615385
"5607",89,97,11,19,30,0.366666666666667
"5608",89,98,8,5,13,0.615384615384615
"5609",89,99,7,17,24,0.291666666666667
"5610",9,10,46,41,87,0.528735632183908
"5611",9,100,233,206,439,0.530751708428246
"5612",9,101,49,56,105,0.466666666666667
"5613",9,102,85,61,146,0.582191780821918
"5614",9,103,17,13,30,0.566666666666667
"5615",9,104,213,241,454,0.469162995594714
"5616",9,105,21,19,40,0.525
"5617",9,106,252,225,477,0.528301886792453
"5618",9,107,59,60,119,0.495798319327731
"5619",9,109,44,41,85,0.517647058823529
"5620",9,11,534,443,977,0.546571136131013
"5621",9,110,80,52,132,0.606060606060606
"5622",9,111,27,17,44,0.613636363636364
"5623",9,112,157,148,305,0.514754098360656
"5624",9,12,84,103,187,0.449197860962567
"5625",9,13,45,56,101,0.445544554455446
"5626",9,14,253,271,524,0.482824427480916
"5627",9,15,50,44,94,0.531914893617021
"5628",9,16,76,69,145,0.524137931034483
"5629",9,17,62,73,135,0.459259259259259
"5630",9,18,101,76,177,0.570621468926554
"5631",9,19,130,163,293,0.443686006825939
"5632",9,20,79,79,158,0.5
"5633",9,21,544,531,1075,0.506046511627907
"5634",9,22,148,85,233,0.63519313304721
"5635",9,23,77,73,150,0.513333333333333
"5636",9,25,163,202,365,0.446575342465753
"5637",9,26,165,161,326,0.506134969325153
"5638",9,27,78,78,156,0.5
"5639",9,28,315,255,570,0.552631578947368
"5640",9,29,86,53,139,0.618705035971223
"5641",9,30,152,140,292,0.520547945205479
"5642",9,31,92,76,168,0.547619047619048
"5643",9,32,103,89,192,0.536458333333333
"5644",9,33,54,42,96,0.5625
"5645",9,34,91,73,164,0.554878048780488
"5646",9,35,80,93,173,0.46242774566474
"5647",9,36,175,118,293,0.597269624573379
"5648",9,37,46,31,77,0.597402597402597
"5649",9,38,34,27,61,0.557377049180328
"5650",9,39,242,300,542,0.446494464944649
"5651",9,40,63,51,114,0.552631578947368
"5652",9,41,95,108,203,0.467980295566502
"5653",9,42,258,169,427,0.604215456674473
"5654",9,43,46,44,90,0.511111111111111
"5655",9,44,214,205,419,0.510739856801909
"5656",9,45,36,39,75,0.48
"5657",9,46,153,172,325,0.470769230769231
"5658",9,47,73,76,149,0.48993288590604
"5659",9,48,61,64,125,0.488
"5660",9,49,58,46,104,0.557692307692308
"5661",9,50,178,147,325,0.547692307692308
"5662",9,51,142,109,251,0.565737051792829
"5663",9,52,26,27,53,0.490566037735849
"5664",9,53,52,83,135,0.385185185185185
"5665",9,54,67,75,142,0.471830985915493
"5666",9,55,86,87,173,0.497109826589595
"5667",9,56,44,57,101,0.435643564356436
"5668",9,57,133,108,241,0.551867219917012
"5669",9,58,16,28,44,0.363636363636364
"5670",9,59,83,83,166,0.5
"5671",9,60,72,74,146,0.493150684931507
"5672",9,61,25,35,60,0.416666666666667
"5673",9,62,130,128,258,0.503875968992248
"5674",9,63,50,67,117,0.427350427350427
"5675",9,64,58,49,107,0.542056074766355
"5676",9,65,28,31,59,0.474576271186441
"5677",9,66,13,10,23,0.565217391304348
"5678",9,67,260,156,416,0.625
"5679",9,68,133,144,277,0.48014440433213
"5680",9,69,208,160,368,0.565217391304348
"5681",9,70,136,104,240,0.566666666666667
"5682",9,71,164,129,293,0.559726962457338
"5683",9,72,180,171,351,0.512820512820513
"5684",9,73,319,259,578,0.551903114186851
"5685",9,74,311,341,652,0.476993865030675
"5686",9,75,182,158,340,0.535294117647059
"5687",9,76,38,39,77,0.493506493506494
"5688",9,77,32,11,43,0.744186046511628
"5689",9,78,43,23,66,0.651515151515151
"5690",9,79,37,54,91,0.406593406593407
"5691",9,80,22,28,50,0.44
"5692",9,81,60,68,128,0.46875
"5693",9,82,44,38,82,0.536585365853659
"5694",9,83,31,35,66,0.46969696969697
"5695",9,84,117,95,212,0.55188679245283
"5696",9,85,142,104,246,0.577235772357724
"5697",9,86,151,191,342,0.441520467836257
"5698",9,87,95,87,182,0.521978021978022
"5699",9,88,69,59,128,0.5390625
"5700",9,89,22,30,52,0.423076923076923
"5701",9,90,43,45,88,0.488636363636364
"5702",9,91,28,32,60,0.466666666666667
"5703",9,92,18,18,36,0.5
"5704",9,93,227,227,454,0.5
"5705",9,94,67,67,134,0.5
"5706",9,95,39,48,87,0.448275862068966
"5707",9,96,52,43,95,0.547368421052632
"5708",9,97,92,93,185,0.497297297297297
"5709",9,98,67,96,163,0.411042944785276
"5710",9,99,98,100,198,0.494949494949495
"5711",90,100,59,74,133,0.443609022556391
"5712",90,101,14,19,33,0.424242424242424
"5713",90,102,28,17,45,0.622222222222222
"5714",90,103,6,2,8,0.75
"5715",90,104,60,79,139,0.431654676258993
"5716",90,105,10,13,23,0.434782608695652
"5717",90,106,66,79,145,0.455172413793103
"5718",90,107,21,20,41,0.51219512195122
"5719",90,109,15,14,29,0.517241379310345
"5720",90,110,24,17,41,0.585365853658537
"5721",90,111,4,6,10,0.4
"5722",90,112,30,21,51,0.588235294117647
"5723",90,91,10,6,16,0.625
"5724",90,92,9,5,14,0.642857142857143
"5725",90,93,65,76,141,0.460992907801418
"5726",90,94,24,22,46,0.521739130434783
"5727",90,95,8,9,17,0.470588235294118
"5728",90,96,14,14,28,0.5
"5729",90,97,21,51,72,0.291666666666667
"5730",90,98,21,45,66,0.318181818181818
"5731",90,99,34,58,92,0.369565217391304
"5732",91,100,38,59,97,0.391752577319588
"5733",91,101,12,14,26,0.461538461538462
"5734",91,102,17,11,28,0.607142857142857
"5735",91,103,6,9,15,0.4
"5736",91,104,47,64,111,0.423423423423423
"5737",91,105,3,8,11,0.272727272727273
"5738",91,106,29,50,79,0.367088607594937
"5739",91,107,15,17,32,0.46875
"5740",91,109,6,6,12,0.5
"5741",91,110,12,19,31,0.387096774193548
"5742",91,111,3,8,11,0.272727272727273
"5743",91,112,35,28,63,0.555555555555556
"5744",91,92,5,4,9,0.555555555555556
"5745",91,93,46,61,107,0.429906542056075
"5746",91,94,9,15,24,0.375
"5747",91,95,9,11,20,0.45
"5748",91,96,8,15,23,0.347826086956522
"5749",91,97,17,17,34,0.5
"5750",91,98,17,14,31,0.548387096774194
"5751",91,99,39,52,91,0.428571428571429
"5752",92,100,35,29,64,0.546875
"5753",92,101,4,5,9,0.444444444444444
"5754",92,102,19,9,28,0.678571428571429
"5755",92,103,4,5,9,0.444444444444444
"5756",92,104,31,24,55,0.563636363636364
"5757",92,106,33,36,69,0.478260869565217
"5758",92,107,8,7,15,0.533333333333333
"5759",92,109,10,8,18,0.555555555555556
"5760",92,110,25,14,39,0.641025641025641
"5761",92,112,20,11,31,0.645161290322581
"5762",92,93,33,28,61,0.540983606557377
"5763",92,94,4,7,11,0.363636363636364
"5764",92,95,5,2,7,0.714285714285714
"5765",92,96,9,6,15,0.6
"5766",92,97,13,11,24,0.541666666666667
"5767",92,98,12,13,25,0.48
"5768",92,99,9,14,23,0.391304347826087
"5769",93,100,329,365,694,0.474063400576369
"5770",93,101,112,111,223,0.502242152466368
"5771",93,102,123,88,211,0.582938388625592
"5772",93,103,27,25,52,0.519230769230769
"5773",93,104,236,274,510,0.462745098039216
"5774",93,105,25,43,68,0.367647058823529
"5775",93,106,151,166,317,0.476340694006309
"5776",93,107,109,98,207,0.526570048309179
"5777",93,109,23,22,45,0.511111111111111
"5778",93,110,92,83,175,0.525714285714286
"5779",93,111,34,42,76,0.447368421052632
"5780",93,112,232,290,522,0.444444444444444
"5781",93,94,49,38,87,0.563218390804598
"5782",93,95,30,35,65,0.461538461538462
"5783",93,96,61,66,127,0.480314960629921
"5784",93,97,83,102,185,0.448648648648649
"5785",93,98,77,99,176,0.4375
"5786",93,99,91,138,229,0.397379912663755
"5787",94,100,83,83,166,0.5
"5788",94,101,21,36,57,0.368421052631579
"5789",94,102,35,19,54,0.648148148148148
"5790",94,103,10,6,16,0.625
"5791",94,104,96,91,187,0.513368983957219
"5792",94,105,18,13,31,0.580645161290323
"5793",94,106,52,58,110,0.472727272727273
"5794",94,107,23,16,39,0.58974358974359
"5795",94,109,14,8,22,0.636363636363636
"5796",94,110,38,32,70,0.542857142857143
"5797",94,111,6,6,12,0.5
"5798",94,112,59,76,135,0.437037037037037
"5799",94,95,12,12,24,0.5
"5800",94,96,23,17,40,0.575
"5801",94,97,30,42,72,0.416666666666667
"5802",94,98,12,29,41,0.292682926829268
"5803",94,99,36,37,73,0.493150684931507
"5804",95,100,57,57,114,0.5
"5805",95,101,15,23,38,0.394736842105263
"5806",95,102,16,31,47,0.340425531914894
"5807",95,103,5,6,11,0.454545454545455
"5808",95,104,42,72,114,0.368421052631579
"5809",95,105,7,5,12,0.583333333333333
"5810",95,106,33,34,67,0.492537313432836
"5811",95,107,14,14,28,0.5
"5812",95,109,4,4,8,0.5
"5813",95,110,17,22,39,0.435897435897436
"5814",95,111,4,8,12,0.333333333333333
"5815",95,112,42,55,97,0.43298969072165
"5816",95,96,9,20,29,0.310344827586207
"5817",95,97,21,31,52,0.403846153846154
"5818",95,98,13,15,28,0.464285714285714
"5819",95,99,31,32,63,0.492063492063492
"5820",96,100,80,69,149,0.536912751677852
"5821",96,101,18,30,48,0.375
"5822",96,102,18,15,33,0.545454545454545
"5823",96,104,65,63,128,0.5078125
"5824",96,105,7,5,12,0.583333333333333
"5825",96,106,58,53,111,0.522522522522523
"5826",96,107,9,16,25,0.36
"5827",96,109,9,20,29,0.310344827586207
"5828",96,110,11,7,18,0.611111111111111
"5829",96,111,6,2,8,0.75
"5830",96,112,56,60,116,0.482758620689655
"5831",96,97,12,9,21,0.571428571428571
"5832",96,98,5,7,12,0.416666666666667
"5833",96,99,8,8,16,0.5
"5834",97,100,107,134,241,0.443983402489627
"5835",97,101,27,60,87,0.310344827586207
"5836",97,102,34,37,71,0.47887323943662
"5837",97,103,11,12,23,0.478260869565217
"5838",97,104,87,107,194,0.448453608247423
"5839",97,105,20,32,52,0.384615384615385
"5840",97,106,132,184,316,0.417721518987342
"5841",97,107,24,25,49,0.489795918367347
"5842",97,109,13,13,26,0.5
"5843",97,110,28,35,63,0.444444444444444
"5844",97,111,11,19,30,0.366666666666667
"5845",97,112,96,152,248,0.387096774193548
"5846",97,98,26,32,58,0.448275862068966
"5847",97,99,22,36,58,0.379310344827586
"5848",98,100,78,103,181,0.430939226519337
"5849",98,101,28,37,65,0.430769230769231
"5850",98,102,37,25,62,0.596774193548387
"5851",98,103,5,8,13,0.384615384615385
"5852",98,104,69,99,168,0.410714285714286
"5853",98,105,8,14,22,0.363636363636364
"5854",98,106,60,94,154,0.38961038961039
"5855",98,107,18,24,42,0.428571428571429
"5856",98,109,9,17,26,0.346153846153846
"5857",98,110,10,21,31,0.32258064516129
"5858",98,111,8,18,26,0.307692307692308
"5859",98,112,80,92,172,0.465116279069767
"5860",98,99,11,24,35,0.314285714285714
"5861",99,100,87,100,187,0.46524064171123
"5862",99,101,41,53,94,0.436170212765957
"5863",99,102,47,44,91,0.516483516483517
"5864",99,103,7,12,19,0.368421052631579
"5865",99,104,113,158,271,0.416974169741697
"5866",99,105,16,34,50,0.32
"5867",99,106,105,127,232,0.452586206896552
"5868",99,107,29,24,53,0.547169811320755
"5869",99,109,24,16,40,0.6
"5870",99,110,31,30,61,0.508196721311475
"5871",99,111,12,21,33,0.363636363636364
"5872",99,112,132,121,253,0.521739130434783
