"Hero1","H1name","Hero2","H2name","wins","losses","num_of_picks","win_percentage","pickpermedian"
1,"Anti-Mage",2,"Axe",139,196,335,0.414925373134328,4.29487179487179
1,"Anti-Mage",3,"Bane",84,116,200,0.42,2.56410256410256
1,"Anti-Mage",4,"Bloodseeker",53,92,145,0.36551724137931,1.85897435897436
1,"Anti-Mage",5,"Crystal Maiden",273,304,577,0.47313691507799,7.3974358974359
1,"Anti-Mage",6,"Drow Ranger",42,47,89,0.471910112359551,1.14102564102564
1,"Anti-Mage",7,"Earthshaker",468,484,952,0.491596638655462,12.2051282051282
1,"Anti-Mage",8,"Juggernaut",79,100,179,0.441340782122905,2.29487179487179
1,"Anti-Mage",9,"Mirana",252,272,524,0.480916030534351,6.71794871794872
1,"Anti-Mage",10,"Morphling",21,44,65,0.323076923076923,0.833333333333333
1,"Anti-Mage",11,"Shadow Fiend",598,658,1256,0.476114649681529,16.1025641025641
1,"Anti-Mage",12,"Phantom Lancer",16,29,45,0.355555555555556,0.576923076923077
1,"Anti-Mage",13,"Puck",59,83,142,0.415492957746479,1.82051282051282
1,"Anti-Mage",14,"Pudge",358,385,743,0.481830417227456,9.52564102564103
1,"Anti-Mage",15,"Razor",45,53,98,0.459183673469388,1.25641025641026
1,"Anti-Mage",16,"Sand King",116,156,272,0.426470588235294,3.48717948717949
1,"Anti-Mage",17,"Storm Spirit",67,120,187,0.358288770053476,2.3974358974359
1,"Anti-Mage",18,"Sven",40,57,97,0.412371134020619,1.24358974358974
1,"Anti-Mage",19,"Tiny",93,152,245,0.379591836734694,3.14102564102564
1,"Anti-Mage",20,"Vengeful Spirit",153,139,292,0.523972602739726,3.74358974358974
1,"Anti-Mage",21,"Windranger",708,865,1573,0.450095359186268,20.1666666666667
1,"Anti-Mage",22,"Zeus",186,159,345,0.539130434782609,4.42307692307692
1,"Anti-Mage",23,"Kunkka",78,92,170,0.458823529411765,2.17948717948718
1,"Anti-Mage",25,"Lina",274,382,656,0.417682926829268,8.41025641025641
1,"Anti-Mage",26,"Lion",279,373,652,0.427914110429448,8.35897435897436
1,"Anti-Mage",27,"Shadow Shaman",133,130,263,0.505703422053232,3.37179487179487
1,"Anti-Mage",28,"Slardar",359,345,704,0.509943181818182,9.02564102564103
1,"Anti-Mage",29,"Tidehunter",79,114,193,0.409326424870466,2.47435897435897
1,"Anti-Mage",30,"Witch Doctor",261,319,580,0.45,7.43589743589744
1,"Anti-Mage",31,"Lich",189,190,379,0.49868073878628,4.85897435897436
1,"Anti-Mage",32,"Riki",122,112,234,0.521367521367521,3
1,"Anti-Mage",33,"Enigma",94,110,204,0.46078431372549,2.61538461538462
1,"Anti-Mage",34,"Tinker",80,126,206,0.388349514563107,2.64102564102564
1,"Anti-Mage",35,"Sniper",64,128,192,0.333333333333333,2.46153846153846
1,"Anti-Mage",36,"Necrophos",224,216,440,0.509090909090909,5.64102564102564
1,"Anti-Mage",37,"Warlock",67,71,138,0.485507246376812,1.76923076923077
1,"Anti-Mage",38,"Beastmaster",43,38,81,0.530864197530864,1.03846153846154
1,"Anti-Mage",39,"Queen of Pain",358,485,843,0.424673784104389,10.8076923076923
1,"Anti-Mage",40,"Venomancer",122,98,220,0.554545454545455,2.82051282051282
1,"Anti-Mage",41,"Faceless Void",23,49,72,0.319444444444444,0.923076923076923
1,"Anti-Mage",42,"Wraith King",103,111,214,0.481308411214953,2.74358974358974
1,"Anti-Mage",43,"Death Prophet",51,75,126,0.404761904761905,1.61538461538462
1,"Anti-Mage",44,"Phantom Assassin",49,78,127,0.385826771653543,1.62820512820513
1,"Anti-Mage",45,"Pugna",53,75,128,0.4140625,1.64102564102564
1,"Anti-Mage",46,"Templar Assassin",189,224,413,0.457627118644068,5.29487179487179
1,"Anti-Mage",47,"Viper",102,119,221,0.461538461538462,2.83333333333333
1,"Anti-Mage",48,"Luna",20,41,61,0.327868852459016,0.782051282051282
1,"Anti-Mage",49,"Dragon Knight",49,65,114,0.429824561403509,1.46153846153846
1,"Anti-Mage",50,"Dazzle",332,368,700,0.474285714285714,8.97435897435897
1,"Anti-Mage",51,"Clockwerk",154,184,338,0.455621301775148,4.33333333333333
1,"Anti-Mage",52,"Leshrac",35,48,83,0.421686746987952,1.06410256410256
1,"Anti-Mage",53,"Nature's Prophet",83,154,237,0.350210970464135,3.03846153846154
1,"Anti-Mage",54,"Lifestealer",42,58,100,0.42,1.28205128205128
1,"Anti-Mage",55,"Dark Seer",149,174,323,0.461300309597523,4.14102564102564
1,"Anti-Mage",56,"Clinkz",49,62,111,0.441441441441441,1.42307692307692
1,"Anti-Mage",57,"Omniknight",186,179,365,0.50958904109589,4.67948717948718
1,"Anti-Mage",58,"Enchantress",26,57,83,0.313253012048193,1.06410256410256
1,"Anti-Mage",59,"Huskar",73,122,195,0.374358974358974,2.5
1,"Anti-Mage",60,"Night Stalker",108,109,217,0.497695852534562,2.78205128205128
1,"Anti-Mage",61,"Broodmother",48,68,116,0.413793103448276,1.48717948717949
1,"Anti-Mage",62,"Bounty Hunter",215,265,480,0.447916666666667,6.15384615384615
1,"Anti-Mage",63,"Weaver",55,63,118,0.466101694915254,1.51282051282051
1,"Anti-Mage",64,"Jakiro",101,96,197,0.512690355329949,2.52564102564103
1,"Anti-Mage",65,"Batrider",38,51,89,0.426966292134831,1.14102564102564
1,"Anti-Mage",66,"Chen",17,30,47,0.361702127659574,0.602564102564103
1,"Anti-Mage",67,"Spectre",32,36,68,0.470588235294118,0.871794871794872
1,"Anti-Mage",68,"Ancient Apparition",234,257,491,0.476578411405295,6.29487179487179
1,"Anti-Mage",69,"Doom",282,294,576,0.489583333333333,7.38461538461539
1,"Anti-Mage",70,"Ursa",83,85,168,0.494047619047619,2.15384615384615
1,"Anti-Mage",71,"Spirit Breaker",255,238,493,0.517241379310345,6.32051282051282
1,"Anti-Mage",72,"Gyrocopter",49,77,126,0.388888888888889,1.61538461538462
1,"Anti-Mage",73,"Alchemist",230,270,500,0.46,6.41025641025641
1,"Anti-Mage",74,"Invoker",465,499,964,0.482365145228216,12.3589743589744
1,"Anti-Mage",75,"Silencer",268,291,559,0.479427549194991,7.16666666666667
1,"Anti-Mage",76,"Outworld Devourer",35,56,91,0.384615384615385,1.16666666666667
1,"Anti-Mage",77,"Lycan",26,21,47,0.553191489361702,0.602564102564103
1,"Anti-Mage",78,"Brewmaster",29,35,64,0.453125,0.82051282051282
1,"Anti-Mage",79,"Shadow Demon",39,64,103,0.378640776699029,1.32051282051282
1,"Anti-Mage",80,"Lone Druid",28,42,70,0.4,0.897435897435897
1,"Anti-Mage",81,"Chaos Knight",26,47,73,0.356164383561644,0.935897435897436
1,"Anti-Mage",82,"Meepo",44,45,89,0.49438202247191,1.14102564102564
1,"Anti-Mage",83,"Treant Protector",61,67,128,0.4765625,1.64102564102564
1,"Anti-Mage",84,"Ogre Magi",173,188,361,0.479224376731302,4.62820512820513
1,"Anti-Mage",85,"Undying",233,185,418,0.557416267942584,5.35897435897436
1,"Anti-Mage",86,"Rubick",285,406,691,0.412445730824891,8.85897435897436
1,"Anti-Mage",87,"Disruptor",202,205,407,0.496314496314496,5.21794871794872
1,"Anti-Mage",88,"Nyx Assassin",113,115,228,0.495614035087719,2.92307692307692
1,"Anti-Mage",89,"Naga Siren",20,27,47,0.425531914893617,0.602564102564103
1,"Anti-Mage",90,"Keeper of the Light",68,95,163,0.417177914110429,2.08974358974359
1,"Anti-Mage",91,"Io",26,54,80,0.325,1.02564102564103
1,"Anti-Mage",92,"Visage",28,42,70,0.4,0.897435897435897
1,"Anti-Mage",93,"Slark",79,88,167,0.473053892215569,2.14102564102564
1,"Anti-Mage",94,"Medusa",21,29,50,0.42,0.641025641025641
1,"Anti-Mage",95,"Troll Warlord",18,32,50,0.36,0.641025641025641
1,"Anti-Mage",96,"Centaur Warrunner",71,65,136,0.522058823529412,1.74358974358974
1,"Anti-Mage",97,"Magnus",140,189,329,0.425531914893617,4.21794871794872
1,"Anti-Mage",98,"Timbersaw",85,145,230,0.369565217391304,2.94871794871795
1,"Anti-Mage",99,"Bristleback",112,155,267,0.419475655430712,3.42307692307692
1,"Anti-Mage",100,"Tusk",378,410,788,0.479695431472081,10.1025641025641
1,"Anti-Mage",101,"Skywrath Mage",103,146,249,0.413654618473896,3.19230769230769
1,"Anti-Mage",102,"Abaddon",140,111,251,0.557768924302789,3.21794871794872
1,"Anti-Mage",103,"Elder Titan",27,32,59,0.457627118644068,0.756410256410256
1,"Anti-Mage",104,"Legion Commander",256,295,551,0.464609800362976,7.06410256410256
1,"Anti-Mage",105,"Techies",48,65,113,0.424778761061947,1.44871794871795
1,"Anti-Mage",106,"Ember Spirit",160,179,339,0.471976401179941,4.34615384615385
1,"Anti-Mage",107,"Earth Spirit",97,103,200,0.485,2.56410256410256
1,"Anti-Mage",109,"Terrorblade",12,26,38,0.315789473684211,0.487179487179487
1,"Anti-Mage",110,"Phoenix",121,123,244,0.495901639344262,3.12820512820513
1,"Anti-Mage",111,"Oracle",37,42,79,0.468354430379747,1.01282051282051
1,"Anti-Mage",112,"Winter Wyvern",339,323,662,0.512084592145015,8.48717948717949
2,"Axe",3,"Bane",36,41,77,0.467532467532468,0.987179487179487
2,"Axe",4,"Bloodseeker",33,41,74,0.445945945945946,0.948717948717949
2,"Axe",5,"Crystal Maiden",134,139,273,0.490842490842491,3.5
2,"Axe",6,"Drow Ranger",59,47,106,0.556603773584906,1.35897435897436
2,"Axe",7,"Earthshaker",120,170,290,0.413793103448276,3.71794871794872
2,"Axe",8,"Juggernaut",172,193,365,0.471232876712329,4.67948717948718
2,"Axe",9,"Mirana",93,112,205,0.453658536585366,2.62820512820513
2,"Axe",10,"Morphling",26,40,66,0.393939393939394,0.846153846153846
2,"Axe",11,"Shadow Fiend",259,324,583,0.444253859348199,7.47435897435897
2,"Axe",12,"Phantom Lancer",53,100,153,0.34640522875817,1.96153846153846
2,"Axe",13,"Puck",25,43,68,0.367647058823529,0.871794871794872
2,"Axe",14,"Pudge",106,151,257,0.412451361867704,3.29487179487179
2,"Axe",15,"Razor",30,46,76,0.394736842105263,0.974358974358974
2,"Axe",16,"Sand King",31,50,81,0.382716049382716,1.03846153846154
2,"Axe",17,"Storm Spirit",30,68,98,0.306122448979592,1.25641025641026
2,"Axe",18,"Sven",43,52,95,0.452631578947368,1.21794871794872
2,"Axe",19,"Tiny",66,84,150,0.44,1.92307692307692
2,"Axe",20,"Vengeful Spirit",56,80,136,0.411764705882353,1.74358974358974
2,"Axe",21,"Windranger",316,440,756,0.417989417989418,9.69230769230769
2,"Axe",22,"Zeus",83,78,161,0.515527950310559,2.06410256410256
2,"Axe",23,"Kunkka",26,38,64,0.40625,0.82051282051282
2,"Axe",25,"Lina",103,185,288,0.357638888888889,3.69230769230769
2,"Axe",26,"Lion",102,130,232,0.439655172413793,2.97435897435897
2,"Axe",27,"Shadow Shaman",51,67,118,0.432203389830508,1.51282051282051
2,"Axe",28,"Slardar",88,137,225,0.391111111111111,2.88461538461538
2,"Axe",29,"Tidehunter",21,32,53,0.39622641509434,0.67948717948718
2,"Axe",30,"Witch Doctor",124,141,265,0.467924528301887,3.3974358974359
2,"Axe",31,"Lich",64,77,141,0.453900709219858,1.80769230769231
2,"Axe",32,"Riki",68,74,142,0.47887323943662,1.82051282051282
2,"Axe",33,"Enigma",29,21,50,0.58,0.641025641025641
2,"Axe",34,"Tinker",41,65,106,0.386792452830189,1.35897435897436
2,"Axe",35,"Sniper",64,112,176,0.363636363636364,2.25641025641026
2,"Axe",36,"Necrophos",92,125,217,0.423963133640553,2.78205128205128
2,"Axe",37,"Warlock",36,42,78,0.461538461538462,1
2,"Axe",38,"Beastmaster",12,13,25,0.48,0.320512820512821
2,"Axe",39,"Queen of Pain",121,224,345,0.350724637681159,4.42307692307692
2,"Axe",40,"Venomancer",46,55,101,0.455445544554455,1.29487179487179
2,"Axe",41,"Faceless Void",54,65,119,0.453781512605042,1.52564102564103
2,"Axe",42,"Wraith King",115,91,206,0.558252427184466,2.64102564102564
2,"Axe",43,"Death Prophet",37,38,75,0.493333333333333,0.961538461538462
2,"Axe",44,"Phantom Assassin",128,164,292,0.438356164383562,3.74358974358974
2,"Axe",45,"Pugna",18,28,46,0.391304347826087,0.58974358974359
2,"Axe",46,"Templar Assassin",96,144,240,0.4,3.07692307692308
2,"Axe",47,"Viper",64,70,134,0.477611940298507,1.71794871794872
2,"Axe",48,"Luna",38,55,93,0.408602150537634,1.19230769230769
2,"Axe",49,"Dragon Knight",25,31,56,0.446428571428571,0.717948717948718
2,"Axe",50,"Dazzle",165,171,336,0.491071428571429,4.30769230769231
2,"Axe",51,"Clockwerk",39,52,91,0.428571428571429,1.16666666666667
2,"Axe",52,"Leshrac",17,25,42,0.404761904761905,0.538461538461538
2,"Axe",53,"Nature's Prophet",37,41,78,0.474358974358974,1
2,"Axe",54,"Lifestealer",28,38,66,0.424242424242424,0.846153846153846
2,"Axe",55,"Dark Seer",62,67,129,0.48062015503876,1.65384615384615
2,"Axe",56,"Clinkz",40,45,85,0.470588235294118,1.08974358974359
2,"Axe",57,"Omniknight",125,93,218,0.573394495412844,2.79487179487179
2,"Axe",58,"Enchantress",9,13,22,0.409090909090909,0.282051282051282
2,"Axe",59,"Huskar",46,70,116,0.396551724137931,1.48717948717949
2,"Axe",60,"Night Stalker",34,44,78,0.435897435897436,1
2,"Axe",61,"Broodmother",15,32,47,0.319148936170213,0.602564102564103
2,"Axe",62,"Bounty Hunter",72,104,176,0.409090909090909,2.25641025641026
2,"Axe",63,"Weaver",41,66,107,0.383177570093458,1.37179487179487
2,"Axe",64,"Jakiro",44,56,100,0.44,1.28205128205128
2,"Axe",65,"Batrider",11,24,35,0.314285714285714,0.448717948717949
2,"Axe",66,"Chen",5,6,11,0.454545454545455,0.141025641025641
2,"Axe",67,"Spectre",103,120,223,0.461883408071749,2.85897435897436
2,"Axe",68,"Ancient Apparition",113,144,257,0.439688715953307,3.29487179487179
2,"Axe",69,"Doom",51,77,128,0.3984375,1.64102564102564
2,"Axe",70,"Ursa",60,53,113,0.530973451327434,1.44871794871795
2,"Axe",71,"Spirit Breaker",62,83,145,0.427586206896552,1.85897435897436
2,"Axe",72,"Gyrocopter",102,149,251,0.406374501992032,3.21794871794872
2,"Axe",73,"Alchemist",139,190,329,0.422492401215805,4.21794871794872
2,"Axe",74,"Invoker",189,256,445,0.424719101123596,5.70512820512821
2,"Axe",75,"Silencer",134,124,258,0.51937984496124,3.30769230769231
2,"Axe",76,"Outworld Devourer",22,32,54,0.407407407407407,0.692307692307692
2,"Axe",77,"Lycan",7,15,22,0.318181818181818,0.282051282051282
2,"Axe",78,"Brewmaster",10,9,19,0.526315789473684,0.243589743589744
2,"Axe",79,"Shadow Demon",12,32,44,0.272727272727273,0.564102564102564
2,"Axe",80,"Lone Druid",5,19,24,0.208333333333333,0.307692307692308
2,"Axe",81,"Chaos Knight",28,42,70,0.4,0.897435897435897
2,"Axe",82,"Meepo",19,32,51,0.372549019607843,0.653846153846154
2,"Axe",83,"Treant Protector",18,21,39,0.461538461538462,0.5
2,"Axe",84,"Ogre Magi",52,59,111,0.468468468468468,1.42307692307692
2,"Axe",85,"Undying",70,62,132,0.53030303030303,1.69230769230769
2,"Axe",86,"Rubick",79,147,226,0.349557522123894,2.8974358974359
2,"Axe",87,"Disruptor",62,84,146,0.424657534246575,1.87179487179487
2,"Axe",88,"Nyx Assassin",31,51,82,0.378048780487805,1.05128205128205
2,"Axe",89,"Naga Siren",11,17,28,0.392857142857143,0.358974358974359
2,"Axe",90,"Keeper of the Light",33,45,78,0.423076923076923,1
2,"Axe",91,"Io",12,25,37,0.324324324324324,0.474358974358974
2,"Axe",92,"Visage",9,15,24,0.375,0.307692307692308
2,"Axe",93,"Slark",125,178,303,0.412541254125413,3.88461538461538
2,"Axe",94,"Medusa",37,43,80,0.4625,1.02564102564103
2,"Axe",95,"Troll Warlord",27,43,70,0.385714285714286,0.897435897435897
2,"Axe",96,"Centaur Warrunner",16,11,27,0.592592592592593,0.346153846153846
2,"Axe",97,"Magnus",25,73,98,0.255102040816327,1.25641025641026
2,"Axe",98,"Timbersaw",21,37,58,0.362068965517241,0.743589743589744
2,"Axe",99,"Bristleback",40,43,83,0.481927710843373,1.06410256410256
2,"Axe",100,"Tusk",101,129,230,0.439130434782609,2.94871794871795
2,"Axe",101,"Skywrath Mage",34,68,102,0.333333333333333,1.30769230769231
2,"Axe",102,"Abaddon",57,52,109,0.522935779816514,1.3974358974359
2,"Axe",103,"Elder Titan",10,12,22,0.454545454545455,0.282051282051282
2,"Axe",104,"Legion Commander",104,158,262,0.396946564885496,3.35897435897436
2,"Axe",105,"Techies",10,19,29,0.344827586206897,0.371794871794872
2,"Axe",106,"Ember Spirit",96,141,237,0.40506329113924,3.03846153846154
2,"Axe",107,"Earth Spirit",31,41,72,0.430555555555556,0.923076923076923
2,"Axe",109,"Terrorblade",25,29,54,0.462962962962963,0.692307692307692
2,"Axe",110,"Phoenix",38,38,76,0.5,0.974358974358974
2,"Axe",111,"Oracle",14,24,38,0.368421052631579,0.487179487179487
2,"Axe",112,"Winter Wyvern",101,140,241,0.419087136929461,3.08974358974359
3,"Bane",4,"Bloodseeker",19,21,40,0.475,0.512820512820513
3,"Bane",5,"Crystal Maiden",30,35,65,0.461538461538462,0.833333333333333
3,"Bane",6,"Drow Ranger",14,24,38,0.368421052631579,0.487179487179487
3,"Bane",7,"Earthshaker",94,97,191,0.492146596858639,2.44871794871795
3,"Bane",8,"Juggernaut",134,121,255,0.525490196078431,3.26923076923077
3,"Bane",9,"Mirana",126,137,263,0.479087452471483,3.37179487179487
3,"Bane",10,"Morphling",10,14,24,0.416666666666667,0.307692307692308
3,"Bane",11,"Shadow Fiend",189,158,347,0.544668587896254,4.44871794871795
3,"Bane",12,"Phantom Lancer",43,39,82,0.524390243902439,1.05128205128205
3,"Bane",13,"Puck",18,20,38,0.473684210526316,0.487179487179487
3,"Bane",14,"Pudge",80,96,176,0.454545454545455,2.25641025641026
3,"Bane",15,"Razor",27,34,61,0.442622950819672,0.782051282051282
3,"Bane",16,"Sand King",21,27,48,0.4375,0.615384615384615
3,"Bane",17,"Storm Spirit",15,31,46,0.326086956521739,0.58974358974359
3,"Bane",18,"Sven",20,36,56,0.357142857142857,0.717948717948718
3,"Bane",19,"Tiny",54,63,117,0.461538461538462,1.5
3,"Bane",20,"Vengeful Spirit",20,23,43,0.465116279069767,0.551282051282051
3,"Bane",21,"Windranger",159,227,386,0.411917098445596,4.94871794871795
3,"Bane",22,"Zeus",48,36,84,0.571428571428571,1.07692307692308
3,"Bane",23,"Kunkka",22,29,51,0.431372549019608,0.653846153846154
3,"Bane",25,"Lina",49,78,127,0.385826771653543,1.62820512820513
3,"Bane",26,"Lion",35,35,70,0.5,0.897435897435897
3,"Bane",27,"Shadow Shaman",22,15,37,0.594594594594595,0.474358974358974
3,"Bane",28,"Slardar",130,117,247,0.526315789473684,3.16666666666667
3,"Bane",29,"Tidehunter",29,32,61,0.475409836065574,0.782051282051282
3,"Bane",30,"Witch Doctor",43,28,71,0.605633802816901,0.91025641025641
3,"Bane",31,"Lich",33,34,67,0.492537313432836,0.858974358974359
3,"Bane",32,"Riki",28,27,55,0.509090909090909,0.705128205128205
3,"Bane",33,"Enigma",11,20,31,0.354838709677419,0.397435897435897
3,"Bane",34,"Tinker",19,32,51,0.372549019607843,0.653846153846154
3,"Bane",35,"Sniper",17,31,48,0.354166666666667,0.615384615384615
3,"Bane",36,"Necrophos",48,53,101,0.475247524752475,1.29487179487179
3,"Bane",37,"Warlock",10,15,25,0.4,0.320512820512821
3,"Bane",38,"Beastmaster",13,20,33,0.393939393939394,0.423076923076923
3,"Bane",39,"Queen of Pain",97,113,210,0.461904761904762,2.69230769230769
3,"Bane",40,"Venomancer",15,16,31,0.483870967741935,0.397435897435897
3,"Bane",41,"Faceless Void",28,33,61,0.459016393442623,0.782051282051282
3,"Bane",42,"Wraith King",75,80,155,0.483870967741935,1.98717948717949
3,"Bane",43,"Death Prophet",15,14,29,0.517241379310345,0.371794871794872
3,"Bane",44,"Phantom Assassin",63,90,153,0.411764705882353,1.96153846153846
3,"Bane",45,"Pugna",4,11,15,0.266666666666667,0.192307692307692
3,"Bane",46,"Templar Assassin",63,64,127,0.496062992125984,1.62820512820513
3,"Bane",47,"Viper",36,44,80,0.45,1.02564102564103
3,"Bane",48,"Luna",29,17,46,0.630434782608696,0.58974358974359
3,"Bane",49,"Dragon Knight",17,25,42,0.404761904761905,0.538461538461538
3,"Bane",50,"Dazzle",29,47,76,0.381578947368421,0.974358974358974
3,"Bane",51,"Clockwerk",41,62,103,0.398058252427184,1.32051282051282
3,"Bane",52,"Leshrac",10,12,22,0.454545454545455,0.282051282051282
3,"Bane",53,"Nature's Prophet",17,24,41,0.414634146341463,0.525641025641026
3,"Bane",54,"Lifestealer",20,23,43,0.465116279069767,0.551282051282051
3,"Bane",55,"Dark Seer",43,36,79,0.544303797468354,1.01282051282051
3,"Bane",56,"Clinkz",21,26,47,0.446808510638298,0.602564102564103
3,"Bane",57,"Omniknight",45,27,72,0.625,0.923076923076923
3,"Bane",58,"Enchantress",4,8,12,0.333333333333333,0.153846153846154
3,"Bane",59,"Huskar",30,40,70,0.428571428571429,0.897435897435897
3,"Bane",60,"Night Stalker",31,36,67,0.462686567164179,0.858974358974359
3,"Bane",61,"Broodmother",16,14,30,0.533333333333333,0.384615384615385
3,"Bane",62,"Bounty Hunter",35,70,105,0.333333333333333,1.34615384615385
3,"Bane",63,"Weaver",22,30,52,0.423076923076923,0.666666666666667
3,"Bane",64,"Jakiro",14,25,39,0.358974358974359,0.5
3,"Bane",65,"Batrider",7,11,18,0.388888888888889,0.230769230769231
3,"Bane",66,"Chen",7,5,12,0.583333333333333,0.153846153846154
3,"Bane",67,"Spectre",82,61,143,0.573426573426573,1.83333333333333
3,"Bane",68,"Ancient Apparition",41,48,89,0.460674157303371,1.14102564102564
3,"Bane",69,"Doom",67,74,141,0.475177304964539,1.80769230769231
3,"Bane",70,"Ursa",44,38,82,0.536585365853659,1.05128205128205
3,"Bane",71,"Spirit Breaker",52,51,103,0.504854368932039,1.32051282051282
3,"Bane",72,"Gyrocopter",90,97,187,0.481283422459893,2.3974358974359
3,"Bane",73,"Alchemist",95,100,195,0.487179487179487,2.5
3,"Bane",74,"Invoker",97,137,234,0.414529914529915,3
3,"Bane",75,"Silencer",53,49,102,0.519607843137255,1.30769230769231
3,"Bane",76,"Outworld Devourer",18,12,30,0.6,0.384615384615385
3,"Bane",77,"Lycan",9,9,18,0.5,0.230769230769231
3,"Bane",78,"Brewmaster",15,12,27,0.555555555555556,0.346153846153846
3,"Bane",79,"Shadow Demon",6,10,16,0.375,0.205128205128205
3,"Bane",80,"Lone Druid",6,8,14,0.428571428571429,0.179487179487179
3,"Bane",81,"Chaos Knight",20,18,38,0.526315789473684,0.487179487179487
3,"Bane",82,"Meepo",22,16,38,0.578947368421053,0.487179487179487
3,"Bane",83,"Treant Protector",8,8,16,0.5,0.205128205128205
3,"Bane",84,"Ogre Magi",21,21,42,0.5,0.538461538461538
3,"Bane",85,"Undying",41,42,83,0.493975903614458,1.06410256410256
3,"Bane",86,"Rubick",38,49,87,0.436781609195402,1.11538461538462
3,"Bane",87,"Disruptor",21,20,41,0.51219512195122,0.525641025641026
3,"Bane",88,"Nyx Assassin",19,32,51,0.372549019607843,0.653846153846154
3,"Bane",89,"Naga Siren",4,13,17,0.235294117647059,0.217948717948718
3,"Bane",90,"Keeper of the Light",11,12,23,0.478260869565217,0.294871794871795
3,"Bane",91,"Io",8,10,18,0.444444444444444,0.230769230769231
3,"Bane",92,"Visage",10,4,14,0.714285714285714,0.179487179487179
3,"Bane",93,"Slark",93,96,189,0.492063492063492,2.42307692307692
3,"Bane",94,"Medusa",21,22,43,0.488372093023256,0.551282051282051
3,"Bane",95,"Troll Warlord",14,17,31,0.451612903225806,0.397435897435897
3,"Bane",96,"Centaur Warrunner",19,24,43,0.441860465116279,0.551282051282051
3,"Bane",97,"Magnus",32,34,66,0.484848484848485,0.846153846153846
3,"Bane",98,"Timbersaw",29,34,63,0.46031746031746,0.807692307692308
3,"Bane",99,"Bristleback",38,39,77,0.493506493506494,0.987179487179487
3,"Bane",100,"Tusk",87,90,177,0.491525423728814,2.26923076923077
3,"Bane",101,"Skywrath Mage",17,13,30,0.566666666666667,0.384615384615385
3,"Bane",102,"Abaddon",25,18,43,0.581395348837209,0.551282051282051
3,"Bane",103,"Elder Titan",4,3,7,0.571428571428571,0.0897435897435897
3,"Bane",104,"Legion Commander",64,94,158,0.40506329113924,2.02564102564103
3,"Bane",105,"Techies",3,7,10,0.3,0.128205128205128
3,"Bane",106,"Ember Spirit",76,105,181,0.419889502762431,2.32051282051282
3,"Bane",107,"Earth Spirit",17,24,41,0.414634146341463,0.525641025641026
3,"Bane",109,"Terrorblade",14,15,29,0.482758620689655,0.371794871794872
3,"Bane",110,"Phoenix",41,28,69,0.594202898550725,0.884615384615385
3,"Bane",111,"Oracle",5,7,12,0.416666666666667,0.153846153846154
3,"Bane",112,"Winter Wyvern",23,46,69,0.333333333333333,0.884615384615385
4,"Bloodseeker",5,"Crystal Maiden",87,87,174,0.5,2.23076923076923
4,"Bloodseeker",6,"Drow Ranger",24,35,59,0.406779661016949,0.756410256410256
4,"Bloodseeker",7,"Earthshaker",120,114,234,0.512820512820513,3
4,"Bloodseeker",8,"Juggernaut",74,86,160,0.4625,2.05128205128205
4,"Bloodseeker",9,"Mirana",58,87,145,0.4,1.85897435897436
4,"Bloodseeker",10,"Morphling",15,21,36,0.416666666666667,0.461538461538462
4,"Bloodseeker",11,"Shadow Fiend",134,145,279,0.480286738351254,3.57692307692308
4,"Bloodseeker",12,"Phantom Lancer",21,31,52,0.403846153846154,0.666666666666667
4,"Bloodseeker",13,"Puck",16,25,41,0.390243902439024,0.525641025641026
4,"Bloodseeker",14,"Pudge",118,114,232,0.508620689655172,2.97435897435897
4,"Bloodseeker",15,"Razor",23,29,52,0.442307692307692,0.666666666666667
4,"Bloodseeker",16,"Sand King",19,40,59,0.322033898305085,0.756410256410256
4,"Bloodseeker",17,"Storm Spirit",20,45,65,0.307692307692308,0.833333333333333
4,"Bloodseeker",18,"Sven",29,41,70,0.414285714285714,0.897435897435897
4,"Bloodseeker",19,"Tiny",54,60,114,0.473684210526316,1.46153846153846
4,"Bloodseeker",20,"Vengeful Spirit",48,39,87,0.551724137931034,1.11538461538462
4,"Bloodseeker",21,"Windranger",177,220,397,0.445843828715365,5.08974358974359
4,"Bloodseeker",22,"Zeus",67,73,140,0.478571428571429,1.79487179487179
4,"Bloodseeker",23,"Kunkka",20,29,49,0.408163265306122,0.628205128205128
4,"Bloodseeker",25,"Lina",67,106,173,0.38728323699422,2.21794871794872
4,"Bloodseeker",26,"Lion",60,107,167,0.359281437125749,2.14102564102564
4,"Bloodseeker",27,"Shadow Shaman",43,32,75,0.573333333333333,0.961538461538462
4,"Bloodseeker",28,"Slardar",95,100,195,0.487179487179487,2.5
4,"Bloodseeker",29,"Tidehunter",25,38,63,0.396825396825397,0.807692307692308
4,"Bloodseeker",30,"Witch Doctor",62,80,142,0.436619718309859,1.82051282051282
4,"Bloodseeker",31,"Lich",36,37,73,0.493150684931507,0.935897435897436
4,"Bloodseeker",32,"Riki",43,37,80,0.5375,1.02564102564103
4,"Bloodseeker",33,"Enigma",19,23,42,0.452380952380952,0.538461538461538
4,"Bloodseeker",34,"Tinker",26,35,61,0.426229508196721,0.782051282051282
4,"Bloodseeker",35,"Sniper",37,56,93,0.397849462365591,1.19230769230769
4,"Bloodseeker",36,"Necrophos",79,94,173,0.456647398843931,2.21794871794872
4,"Bloodseeker",37,"Warlock",28,28,56,0.5,0.717948717948718
4,"Bloodseeker",38,"Beastmaster",10,14,24,0.416666666666667,0.307692307692308
4,"Bloodseeker",39,"Queen of Pain",66,108,174,0.379310344827586,2.23076923076923
4,"Bloodseeker",40,"Venomancer",26,32,58,0.448275862068966,0.743589743589744
4,"Bloodseeker",41,"Faceless Void",22,35,57,0.385964912280702,0.730769230769231
4,"Bloodseeker",42,"Wraith King",75,71,146,0.513698630136986,1.87179487179487
4,"Bloodseeker",43,"Death Prophet",15,30,45,0.333333333333333,0.576923076923077
4,"Bloodseeker",44,"Phantom Assassin",66,77,143,0.461538461538462,1.83333333333333
4,"Bloodseeker",45,"Pugna",16,15,31,0.516129032258065,0.397435897435897
4,"Bloodseeker",46,"Templar Assassin",52,75,127,0.409448818897638,1.62820512820513
4,"Bloodseeker",47,"Viper",34,40,74,0.459459459459459,0.948717948717949
4,"Bloodseeker",48,"Luna",26,25,51,0.509803921568627,0.653846153846154
4,"Bloodseeker",49,"Dragon Knight",18,23,41,0.439024390243902,0.525641025641026
4,"Bloodseeker",50,"Dazzle",63,71,134,0.470149253731343,1.71794871794872
4,"Bloodseeker",51,"Clockwerk",36,52,88,0.409090909090909,1.12820512820513
4,"Bloodseeker",52,"Leshrac",13,21,34,0.382352941176471,0.435897435897436
4,"Bloodseeker",53,"Nature's Prophet",29,43,72,0.402777777777778,0.923076923076923
4,"Bloodseeker",54,"Lifestealer",21,28,49,0.428571428571429,0.628205128205128
4,"Bloodseeker",55,"Dark Seer",31,30,61,0.508196721311475,0.782051282051282
4,"Bloodseeker",56,"Clinkz",25,27,52,0.480769230769231,0.666666666666667
4,"Bloodseeker",57,"Omniknight",62,45,107,0.579439252336449,1.37179487179487
4,"Bloodseeker",58,"Enchantress",9,13,22,0.409090909090909,0.282051282051282
4,"Bloodseeker",59,"Huskar",38,36,74,0.513513513513513,0.948717948717949
4,"Bloodseeker",60,"Night Stalker",21,36,57,0.368421052631579,0.730769230769231
4,"Bloodseeker",61,"Broodmother",8,26,34,0.235294117647059,0.435897435897436
4,"Bloodseeker",62,"Bounty Hunter",49,54,103,0.475728155339806,1.32051282051282
4,"Bloodseeker",63,"Weaver",21,26,47,0.446808510638298,0.602564102564103
4,"Bloodseeker",64,"Jakiro",26,36,62,0.419354838709677,0.794871794871795
4,"Bloodseeker",65,"Batrider",8,15,23,0.347826086956522,0.294871794871795
4,"Bloodseeker",66,"Chen",4,10,14,0.285714285714286,0.179487179487179
4,"Bloodseeker",67,"Spectre",71,49,120,0.591666666666667,1.53846153846154
4,"Bloodseeker",68,"Ancient Apparition",58,56,114,0.508771929824561,1.46153846153846
4,"Bloodseeker",69,"Doom",55,57,112,0.491071428571429,1.43589743589744
4,"Bloodseeker",70,"Ursa",55,36,91,0.604395604395604,1.16666666666667
4,"Bloodseeker",71,"Spirit Breaker",64,72,136,0.470588235294118,1.74358974358974
4,"Bloodseeker",72,"Gyrocopter",45,49,94,0.478723404255319,1.20512820512821
4,"Bloodseeker",73,"Alchemist",93,114,207,0.449275362318841,2.65384615384615
4,"Bloodseeker",74,"Invoker",117,164,281,0.416370106761566,3.6025641025641
4,"Bloodseeker",75,"Silencer",74,81,155,0.47741935483871,1.98717948717949
4,"Bloodseeker",76,"Outworld Devourer",11,20,31,0.354838709677419,0.397435897435897
4,"Bloodseeker",77,"Lycan",8,6,14,0.571428571428571,0.179487179487179
4,"Bloodseeker",78,"Brewmaster",6,9,15,0.4,0.192307692307692
4,"Bloodseeker",79,"Shadow Demon",9,10,19,0.473684210526316,0.243589743589744
4,"Bloodseeker",80,"Lone Druid",5,15,20,0.25,0.256410256410256
4,"Bloodseeker",81,"Chaos Knight",20,28,48,0.416666666666667,0.615384615384615
4,"Bloodseeker",82,"Meepo",10,14,24,0.416666666666667,0.307692307692308
4,"Bloodseeker",83,"Treant Protector",27,27,54,0.5,0.692307692307692
4,"Bloodseeker",84,"Ogre Magi",42,49,91,0.461538461538462,1.16666666666667
4,"Bloodseeker",85,"Undying",51,47,98,0.520408163265306,1.25641025641026
4,"Bloodseeker",86,"Rubick",60,103,163,0.368098159509202,2.08974358974359
4,"Bloodseeker",87,"Disruptor",51,51,102,0.5,1.30769230769231
4,"Bloodseeker",88,"Nyx Assassin",22,29,51,0.431372549019608,0.653846153846154
4,"Bloodseeker",89,"Naga Siren",13,8,21,0.619047619047619,0.269230769230769
4,"Bloodseeker",90,"Keeper of the Light",13,32,45,0.288888888888889,0.576923076923077
4,"Bloodseeker",91,"Io",12,10,22,0.545454545454545,0.282051282051282
4,"Bloodseeker",92,"Visage",5,7,12,0.416666666666667,0.153846153846154
4,"Bloodseeker",93,"Slark",73,74,147,0.496598639455782,1.88461538461538
4,"Bloodseeker",94,"Medusa",35,21,56,0.625,0.717948717948718
4,"Bloodseeker",95,"Troll Warlord",16,21,37,0.432432432432432,0.474358974358974
4,"Bloodseeker",96,"Centaur Warrunner",15,21,36,0.416666666666667,0.461538461538462
4,"Bloodseeker",97,"Magnus",23,34,57,0.403508771929825,0.730769230769231
4,"Bloodseeker",98,"Timbersaw",21,32,53,0.39622641509434,0.67948717948718
4,"Bloodseeker",99,"Bristleback",33,56,89,0.370786516853933,1.14102564102564
4,"Bloodseeker",100,"Tusk",86,96,182,0.472527472527473,2.33333333333333
4,"Bloodseeker",101,"Skywrath Mage",24,35,59,0.406779661016949,0.756410256410256
4,"Bloodseeker",102,"Abaddon",33,31,64,0.515625,0.82051282051282
4,"Bloodseeker",103,"Elder Titan",3,11,14,0.214285714285714,0.179487179487179
4,"Bloodseeker",104,"Legion Commander",91,116,207,0.439613526570048,2.65384615384615
4,"Bloodseeker",105,"Techies",4,18,22,0.181818181818182,0.282051282051282
4,"Bloodseeker",106,"Ember Spirit",67,72,139,0.482014388489209,1.78205128205128
4,"Bloodseeker",107,"Earth Spirit",17,14,31,0.548387096774194,0.397435897435897
4,"Bloodseeker",109,"Terrorblade",20,18,38,0.526315789473684,0.487179487179487
4,"Bloodseeker",110,"Phoenix",38,27,65,0.584615384615385,0.833333333333333
4,"Bloodseeker",111,"Oracle",9,13,22,0.409090909090909,0.282051282051282
4,"Bloodseeker",112,"Winter Wyvern",64,69,133,0.481203007518797,1.70512820512821
5,"Crystal Maiden",6,"Drow Ranger",69,69,138,0.5,1.76923076923077
5,"Crystal Maiden",7,"Earthshaker",277,214,491,0.564154786150713,6.29487179487179
5,"Crystal Maiden",8,"Juggernaut",510,375,885,0.576271186440678,11.3461538461538
5,"Crystal Maiden",9,"Mirana",201,147,348,0.577586206896552,4.46153846153846
5,"Crystal Maiden",10,"Morphling",43,47,90,0.477777777777778,1.15384615384615
5,"Crystal Maiden",11,"Shadow Fiend",559,458,1017,0.549655850540806,13.0384615384615
5,"Crystal Maiden",12,"Phantom Lancer",113,133,246,0.459349593495935,3.15384615384615
5,"Crystal Maiden",13,"Puck",46,55,101,0.455445544554455,1.29487179487179
5,"Crystal Maiden",14,"Pudge",294,230,524,0.561068702290076,6.71794871794872
5,"Crystal Maiden",15,"Razor",72,63,135,0.533333333333333,1.73076923076923
5,"Crystal Maiden",16,"Sand King",79,76,155,0.509677419354839,1.98717948717949
5,"Crystal Maiden",17,"Storm Spirit",86,77,163,0.52760736196319,2.08974358974359
5,"Crystal Maiden",18,"Sven",148,117,265,0.558490566037736,3.3974358974359
5,"Crystal Maiden",19,"Tiny",206,151,357,0.57703081232493,4.57692307692308
5,"Crystal Maiden",20,"Vengeful Spirit",67,62,129,0.51937984496124,1.65384615384615
5,"Crystal Maiden",21,"Windranger",640,590,1230,0.520325203252033,15.7692307692308
5,"Crystal Maiden",22,"Zeus",177,120,297,0.595959595959596,3.80769230769231
5,"Crystal Maiden",23,"Kunkka",80,86,166,0.481927710843373,2.12820512820513
5,"Crystal Maiden",25,"Lina",160,247,407,0.393120393120393,5.21794871794872
5,"Crystal Maiden",26,"Lion",95,84,179,0.53072625698324,2.29487179487179
5,"Crystal Maiden",27,"Shadow Shaman",53,48,101,0.524752475247525,1.29487179487179
5,"Crystal Maiden",28,"Slardar",388,274,662,0.586102719033233,8.48717948717949
5,"Crystal Maiden",29,"Tidehunter",71,70,141,0.50354609929078,1.80769230769231
5,"Crystal Maiden",30,"Witch Doctor",107,110,217,0.493087557603687,2.78205128205128
5,"Crystal Maiden",31,"Lich",77,66,143,0.538461538461538,1.83333333333333
5,"Crystal Maiden",32,"Riki",168,113,281,0.597864768683274,3.6025641025641
5,"Crystal Maiden",33,"Enigma",67,55,122,0.549180327868853,1.56410256410256
5,"Crystal Maiden",34,"Tinker",64,91,155,0.412903225806452,1.98717948717949
5,"Crystal Maiden",35,"Sniper",97,121,218,0.444954128440367,2.79487179487179
5,"Crystal Maiden",36,"Necrophos",173,128,301,0.574750830564784,3.85897435897436
5,"Crystal Maiden",37,"Warlock",40,29,69,0.579710144927536,0.884615384615385
5,"Crystal Maiden",38,"Beastmaster",37,28,65,0.569230769230769,0.833333333333333
5,"Crystal Maiden",39,"Queen of Pain",268,360,628,0.426751592356688,8.05128205128205
5,"Crystal Maiden",40,"Venomancer",71,41,112,0.633928571428571,1.43589743589744
5,"Crystal Maiden",41,"Faceless Void",102,120,222,0.459459459459459,2.84615384615385
5,"Crystal Maiden",42,"Wraith King",309,188,497,0.621730382293763,6.37179487179487
5,"Crystal Maiden",43,"Death Prophet",62,42,104,0.596153846153846,1.33333333333333
5,"Crystal Maiden",44,"Phantom Assassin",228,240,468,0.487179487179487,6
5,"Crystal Maiden",45,"Pugna",29,25,54,0.537037037037037,0.692307692307692
5,"Crystal Maiden",46,"Templar Assassin",212,184,396,0.535353535353535,5.07692307692308
5,"Crystal Maiden",47,"Viper",133,96,229,0.580786026200873,2.93589743589744
5,"Crystal Maiden",48,"Luna",82,72,154,0.532467532467532,1.97435897435897
5,"Crystal Maiden",49,"Dragon Knight",80,57,137,0.583941605839416,1.75641025641026
5,"Crystal Maiden",50,"Dazzle",124,94,218,0.568807339449541,2.79487179487179
5,"Crystal Maiden",51,"Clockwerk",138,131,269,0.513011152416357,3.44871794871795
5,"Crystal Maiden",52,"Leshrac",36,20,56,0.642857142857143,0.717948717948718
5,"Crystal Maiden",53,"Nature's Prophet",64,85,149,0.429530201342282,1.91025641025641
5,"Crystal Maiden",54,"Lifestealer",75,79,154,0.487012987012987,1.97435897435897
5,"Crystal Maiden",55,"Dark Seer",153,100,253,0.604743083003953,3.24358974358974
5,"Crystal Maiden",56,"Clinkz",87,75,162,0.537037037037037,2.07692307692308
5,"Crystal Maiden",57,"Omniknight",131,67,198,0.661616161616162,2.53846153846154
5,"Crystal Maiden",58,"Enchantress",21,19,40,0.525,0.512820512820513
5,"Crystal Maiden",59,"Huskar",101,119,220,0.459090909090909,2.82051282051282
5,"Crystal Maiden",60,"Night Stalker",113,80,193,0.585492227979275,2.47435897435897
5,"Crystal Maiden",61,"Broodmother",47,44,91,0.516483516483517,1.16666666666667
5,"Crystal Maiden",62,"Bounty Hunter",176,145,321,0.548286604361371,4.11538461538461
5,"Crystal Maiden",63,"Weaver",101,87,188,0.537234042553192,2.41025641025641
5,"Crystal Maiden",64,"Jakiro",48,42,90,0.533333333333333,1.15384615384615
5,"Crystal Maiden",65,"Batrider",33,20,53,0.622641509433962,0.67948717948718
5,"Crystal Maiden",66,"Chen",19,12,31,0.612903225806452,0.397435897435897
5,"Crystal Maiden",67,"Spectre",285,204,489,0.582822085889571,6.26923076923077
5,"Crystal Maiden",68,"Ancient Apparition",85,91,176,0.482954545454545,2.25641025641026
5,"Crystal Maiden",69,"Doom",264,211,475,0.55578947368421,6.08974358974359
5,"Crystal Maiden",70,"Ursa",191,121,312,0.612179487179487,4
5,"Crystal Maiden",71,"Spirit Breaker",234,187,421,0.555819477434679,5.3974358974359
5,"Crystal Maiden",72,"Gyrocopter",221,222,443,0.498871331828442,5.67948717948718
5,"Crystal Maiden",73,"Alchemist",386,271,657,0.58751902587519,8.42307692307692
5,"Crystal Maiden",74,"Invoker",377,344,721,0.522884882108183,9.24358974358974
5,"Crystal Maiden",75,"Silencer",174,130,304,0.572368421052632,3.8974358974359
5,"Crystal Maiden",76,"Outworld Devourer",57,44,101,0.564356435643564,1.29487179487179
5,"Crystal Maiden",77,"Lycan",35,26,61,0.573770491803279,0.782051282051282
5,"Crystal Maiden",78,"Brewmaster",35,24,59,0.593220338983051,0.756410256410256
5,"Crystal Maiden",79,"Shadow Demon",15,25,40,0.375,0.512820512820513
5,"Crystal Maiden",80,"Lone Druid",29,27,56,0.517857142857143,0.717948717948718
5,"Crystal Maiden",81,"Chaos Knight",92,82,174,0.528735632183908,2.23076923076923
5,"Crystal Maiden",82,"Meepo",51,49,100,0.51,1.28205128205128
5,"Crystal Maiden",83,"Treant Protector",45,34,79,0.569620253164557,1.01282051282051
5,"Crystal Maiden",84,"Ogre Magi",87,76,163,0.533742331288344,2.08974358974359
5,"Crystal Maiden",85,"Undying",191,141,332,0.575301204819277,4.25641025641026
5,"Crystal Maiden",86,"Rubick",112,125,237,0.472573839662447,3.03846153846154
5,"Crystal Maiden",87,"Disruptor",75,64,139,0.539568345323741,1.78205128205128
5,"Crystal Maiden",88,"Nyx Assassin",77,67,144,0.534722222222222,1.84615384615385
5,"Crystal Maiden",89,"Naga Siren",27,32,59,0.457627118644068,0.756410256410256
5,"Crystal Maiden",90,"Keeper of the Light",32,23,55,0.581818181818182,0.705128205128205
5,"Crystal Maiden",91,"Io",20,36,56,0.357142857142857,0.717948717948718
5,"Crystal Maiden",92,"Visage",17,14,31,0.548387096774194,0.397435897435897
5,"Crystal Maiden",93,"Slark",263,254,517,0.508704061895551,6.62820512820513
5,"Crystal Maiden",94,"Medusa",89,62,151,0.589403973509934,1.93589743589744
5,"Crystal Maiden",95,"Troll Warlord",55,48,103,0.533980582524272,1.32051282051282
5,"Crystal Maiden",96,"Centaur Warrunner",62,72,134,0.462686567164179,1.71794871794872
5,"Crystal Maiden",97,"Magnus",115,113,228,0.504385964912281,2.92307692307692
5,"Crystal Maiden",98,"Timbersaw",112,119,231,0.484848484848485,2.96153846153846
5,"Crystal Maiden",99,"Bristleback",205,169,374,0.548128342245989,4.79487179487179
5,"Crystal Maiden",100,"Tusk",301,268,569,0.528998242530756,7.29487179487179
5,"Crystal Maiden",101,"Skywrath Mage",46,59,105,0.438095238095238,1.34615384615385
5,"Crystal Maiden",102,"Abaddon",99,45,144,0.6875,1.84615384615385
5,"Crystal Maiden",103,"Elder Titan",25,19,44,0.568181818181818,0.564102564102564
5,"Crystal Maiden",104,"Legion Commander",300,239,539,0.556586270871985,6.91025641025641
5,"Crystal Maiden",105,"Techies",29,30,59,0.491525423728814,0.756410256410256
5,"Crystal Maiden",106,"Ember Spirit",248,221,469,0.528784648187633,6.01282051282051
5,"Crystal Maiden",107,"Earth Spirit",78,55,133,0.586466165413534,1.70512820512821
5,"Crystal Maiden",109,"Terrorblade",51,50,101,0.504950495049505,1.29487179487179
5,"Crystal Maiden",110,"Phoenix",87,70,157,0.554140127388535,2.01282051282051
5,"Crystal Maiden",111,"Oracle",15,17,32,0.46875,0.41025641025641
5,"Crystal Maiden",112,"Winter Wyvern",107,109,216,0.49537037037037,2.76923076923077
6,"Drow Ranger",7,"Earthshaker",132,104,236,0.559322033898305,3.02564102564103
6,"Drow Ranger",8,"Juggernaut",51,45,96,0.53125,1.23076923076923
6,"Drow Ranger",9,"Mirana",69,72,141,0.48936170212766,1.80769230769231
6,"Drow Ranger",10,"Morphling",15,16,31,0.483870967741935,0.397435897435897
6,"Drow Ranger",11,"Shadow Fiend",144,124,268,0.537313432835821,3.43589743589744
6,"Drow Ranger",12,"Phantom Lancer",11,21,32,0.34375,0.41025641025641
6,"Drow Ranger",13,"Puck",17,18,35,0.485714285714286,0.448717948717949
6,"Drow Ranger",14,"Pudge",76,107,183,0.415300546448087,2.34615384615385
6,"Drow Ranger",15,"Razor",21,19,40,0.525,0.512820512820513
6,"Drow Ranger",16,"Sand King",28,37,65,0.430769230769231,0.833333333333333
6,"Drow Ranger",17,"Storm Spirit",20,21,41,0.48780487804878,0.525641025641026
6,"Drow Ranger",18,"Sven",23,24,47,0.48936170212766,0.602564102564103
6,"Drow Ranger",19,"Tiny",36,46,82,0.439024390243902,1.05128205128205
6,"Drow Ranger",20,"Vengeful Spirit",104,80,184,0.565217391304348,2.35897435897436
6,"Drow Ranger",21,"Windranger",281,219,500,0.562,6.41025641025641
6,"Drow Ranger",22,"Zeus",41,42,83,0.493975903614458,1.06410256410256
6,"Drow Ranger",23,"Kunkka",22,17,39,0.564102564102564,0.5
6,"Drow Ranger",25,"Lina",74,97,171,0.432748538011696,2.19230769230769
6,"Drow Ranger",26,"Lion",66,64,130,0.507692307692308,1.66666666666667
6,"Drow Ranger",27,"Shadow Shaman",48,42,90,0.533333333333333,1.15384615384615
6,"Drow Ranger",28,"Slardar",90,63,153,0.588235294117647,1.96153846153846
6,"Drow Ranger",29,"Tidehunter",27,36,63,0.428571428571429,0.807692307692308
6,"Drow Ranger",30,"Witch Doctor",59,75,134,0.440298507462687,1.71794871794872
6,"Drow Ranger",31,"Lich",43,25,68,0.632352941176471,0.871794871794872
6,"Drow Ranger",32,"Riki",47,27,74,0.635135135135135,0.948717948717949
6,"Drow Ranger",33,"Enigma",32,29,61,0.524590163934426,0.782051282051282
6,"Drow Ranger",34,"Tinker",22,26,48,0.458333333333333,0.615384615384615
6,"Drow Ranger",35,"Sniper",40,35,75,0.533333333333333,0.961538461538462
6,"Drow Ranger",36,"Necrophos",86,52,138,0.623188405797101,1.76923076923077
6,"Drow Ranger",37,"Warlock",29,22,51,0.568627450980392,0.653846153846154
6,"Drow Ranger",38,"Beastmaster",14,12,26,0.538461538461538,0.333333333333333
6,"Drow Ranger",39,"Queen of Pain",84,91,175,0.48,2.24358974358974
6,"Drow Ranger",40,"Venomancer",40,20,60,0.666666666666667,0.769230769230769
6,"Drow Ranger",41,"Faceless Void",13,25,38,0.342105263157895,0.487179487179487
6,"Drow Ranger",42,"Wraith King",54,39,93,0.580645161290323,1.19230769230769
6,"Drow Ranger",43,"Death Prophet",22,14,36,0.611111111111111,0.461538461538462
6,"Drow Ranger",44,"Phantom Assassin",42,54,96,0.4375,1.23076923076923
6,"Drow Ranger",45,"Pugna",16,12,28,0.571428571428571,0.358974358974359
6,"Drow Ranger",46,"Templar Assassin",65,58,123,0.528455284552846,1.57692307692308
6,"Drow Ranger",47,"Viper",56,31,87,0.64367816091954,1.11538461538462
6,"Drow Ranger",48,"Luna",26,29,55,0.472727272727273,0.705128205128205
6,"Drow Ranger",49,"Dragon Knight",29,25,54,0.537037037037037,0.692307692307692
6,"Drow Ranger",50,"Dazzle",85,61,146,0.582191780821918,1.87179487179487
6,"Drow Ranger",51,"Clockwerk",34,28,62,0.548387096774194,0.794871794871795
6,"Drow Ranger",52,"Leshrac",7,13,20,0.35,0.256410256410256
6,"Drow Ranger",53,"Nature's Prophet",52,49,101,0.514851485148515,1.29487179487179
6,"Drow Ranger",54,"Lifestealer",28,25,53,0.528301886792453,0.67948717948718
6,"Drow Ranger",55,"Dark Seer",24,22,46,0.521739130434783,0.58974358974359
6,"Drow Ranger",56,"Clinkz",24,28,52,0.461538461538462,0.666666666666667
6,"Drow Ranger",57,"Omniknight",84,51,135,0.622222222222222,1.73076923076923
6,"Drow Ranger",58,"Enchantress",13,11,24,0.541666666666667,0.307692307692308
6,"Drow Ranger",59,"Huskar",44,40,84,0.523809523809524,1.07692307692308
6,"Drow Ranger",60,"Night Stalker",32,33,65,0.492307692307692,0.833333333333333
6,"Drow Ranger",61,"Broodmother",10,11,21,0.476190476190476,0.269230769230769
6,"Drow Ranger",62,"Bounty Hunter",53,60,113,0.469026548672566,1.44871794871795
6,"Drow Ranger",63,"Weaver",34,17,51,0.666666666666667,0.653846153846154
6,"Drow Ranger",64,"Jakiro",35,25,60,0.583333333333333,0.769230769230769
6,"Drow Ranger",65,"Batrider",8,5,13,0.615384615384615,0.166666666666667
6,"Drow Ranger",66,"Chen",7,9,16,0.4375,0.205128205128205
6,"Drow Ranger",67,"Spectre",28,24,52,0.538461538461538,0.666666666666667
6,"Drow Ranger",68,"Ancient Apparition",53,62,115,0.460869565217391,1.47435897435897
6,"Drow Ranger",69,"Doom",51,46,97,0.525773195876289,1.24358974358974
6,"Drow Ranger",70,"Ursa",42,32,74,0.567567567567568,0.948717948717949
6,"Drow Ranger",71,"Spirit Breaker",54,67,121,0.446280991735537,1.55128205128205
6,"Drow Ranger",72,"Gyrocopter",51,39,90,0.566666666666667,1.15384615384615
6,"Drow Ranger",73,"Alchemist",65,75,140,0.464285714285714,1.79487179487179
6,"Drow Ranger",74,"Invoker",99,102,201,0.492537313432836,2.57692307692308
6,"Drow Ranger",75,"Silencer",68,49,117,0.581196581196581,1.5
6,"Drow Ranger",76,"Outworld Devourer",13,22,35,0.371428571428571,0.448717948717949
6,"Drow Ranger",77,"Lycan",8,8,16,0.5,0.205128205128205
6,"Drow Ranger",78,"Brewmaster",5,9,14,0.357142857142857,0.179487179487179
6,"Drow Ranger",79,"Shadow Demon",9,19,28,0.321428571428571,0.358974358974359
6,"Drow Ranger",80,"Lone Druid",9,10,19,0.473684210526316,0.243589743589744
6,"Drow Ranger",81,"Chaos Knight",18,16,34,0.529411764705882,0.435897435897436
6,"Drow Ranger",82,"Meepo",10,17,27,0.37037037037037,0.346153846153846
6,"Drow Ranger",83,"Treant Protector",24,18,42,0.571428571428571,0.538461538461538
6,"Drow Ranger",84,"Ogre Magi",62,35,97,0.639175257731959,1.24358974358974
6,"Drow Ranger",85,"Undying",79,57,136,0.580882352941177,1.74358974358974
6,"Drow Ranger",86,"Rubick",65,71,136,0.477941176470588,1.74358974358974
6,"Drow Ranger",87,"Disruptor",40,27,67,0.597014925373134,0.858974358974359
6,"Drow Ranger",88,"Nyx Assassin",19,29,48,0.395833333333333,0.615384615384615
6,"Drow Ranger",89,"Naga Siren",6,9,15,0.4,0.192307692307692
6,"Drow Ranger",90,"Keeper of the Light",23,19,42,0.547619047619048,0.538461538461538
6,"Drow Ranger",91,"Io",11,12,23,0.478260869565217,0.294871794871795
6,"Drow Ranger",92,"Visage",41,36,77,0.532467532467532,0.987179487179487
6,"Drow Ranger",93,"Slark",45,42,87,0.517241379310345,1.11538461538462
6,"Drow Ranger",94,"Medusa",27,14,41,0.658536585365854,0.525641025641026
6,"Drow Ranger",95,"Troll Warlord",17,16,33,0.515151515151515,0.423076923076923
6,"Drow Ranger",96,"Centaur Warrunner",23,28,51,0.450980392156863,0.653846153846154
6,"Drow Ranger",97,"Magnus",16,23,39,0.41025641025641,0.5
6,"Drow Ranger",98,"Timbersaw",18,20,38,0.473684210526316,0.487179487179487
6,"Drow Ranger",99,"Bristleback",41,37,78,0.525641025641026,1
6,"Drow Ranger",100,"Tusk",84,68,152,0.552631578947368,1.94871794871795
6,"Drow Ranger",101,"Skywrath Mage",12,34,46,0.260869565217391,0.58974358974359
6,"Drow Ranger",102,"Abaddon",45,32,77,0.584415584415584,0.987179487179487
6,"Drow Ranger",103,"Elder Titan",8,6,14,0.571428571428571,0.179487179487179
6,"Drow Ranger",104,"Legion Commander",66,88,154,0.428571428571429,1.97435897435897
6,"Drow Ranger",105,"Techies",14,14,28,0.5,0.358974358974359
6,"Drow Ranger",106,"Ember Spirit",35,37,72,0.486111111111111,0.923076923076923
6,"Drow Ranger",107,"Earth Spirit",17,20,37,0.459459459459459,0.474358974358974
6,"Drow Ranger",109,"Terrorblade",11,14,25,0.44,0.320512820512821
6,"Drow Ranger",110,"Phoenix",29,24,53,0.547169811320755,0.67948717948718
6,"Drow Ranger",111,"Oracle",7,16,23,0.304347826086957,0.294871794871795
6,"Drow Ranger",112,"Winter Wyvern",79,52,131,0.603053435114504,1.67948717948718
7,"Earthshaker",8,"Juggernaut",486,415,901,0.539400665926748,11.5512820512821
7,"Earthshaker",9,"Mirana",278,227,505,0.550495049504951,6.47435897435897
7,"Earthshaker",10,"Morphling",66,68,134,0.492537313432836,1.71794871794872
7,"Earthshaker",11,"Shadow Fiend",909,822,1731,0.525129982668977,22.1923076923077
7,"Earthshaker",12,"Phantom Lancer",198,251,449,0.44097995545657,5.75641025641026
7,"Earthshaker",13,"Puck",63,94,157,0.401273885350318,2.01282051282051
7,"Earthshaker",14,"Pudge",330,302,632,0.522151898734177,8.1025641025641
7,"Earthshaker",15,"Razor",90,86,176,0.511363636363636,2.25641025641026
7,"Earthshaker",16,"Sand King",71,86,157,0.452229299363057,2.01282051282051
7,"Earthshaker",17,"Storm Spirit",86,129,215,0.4,2.75641025641026
7,"Earthshaker",18,"Sven",153,141,294,0.520408163265306,3.76923076923077
7,"Earthshaker",19,"Tiny",222,227,449,0.494432071269488,5.75641025641026
7,"Earthshaker",20,"Vengeful Spirit",154,124,278,0.553956834532374,3.56410256410256
7,"Earthshaker",21,"Windranger",941,982,1923,0.489339573582943,24.6538461538462
7,"Earthshaker",22,"Zeus",233,173,406,0.573891625615764,5.20512820512821
7,"Earthshaker",23,"Kunkka",87,103,190,0.457894736842105,2.43589743589744
7,"Earthshaker",25,"Lina",282,375,657,0.429223744292237,8.42307692307692
7,"Earthshaker",26,"Lion",176,211,387,0.454780361757106,4.96153846153846
7,"Earthshaker",27,"Shadow Shaman",114,93,207,0.550724637681159,2.65384615384615
7,"Earthshaker",28,"Slardar",455,367,822,0.55352798053528,10.5384615384615
7,"Earthshaker",29,"Tidehunter",95,72,167,0.568862275449102,2.14102564102564
7,"Earthshaker",30,"Witch Doctor",223,213,436,0.511467889908257,5.58974358974359
7,"Earthshaker",31,"Lich",177,136,313,0.565495207667732,4.01282051282051
7,"Earthshaker",32,"Riki",168,132,300,0.56,3.84615384615385
7,"Earthshaker",33,"Enigma",87,106,193,0.450777202072539,2.47435897435897
7,"Earthshaker",34,"Tinker",100,108,208,0.480769230769231,2.66666666666667
7,"Earthshaker",35,"Sniper",154,175,329,0.468085106382979,4.21794871794872
7,"Earthshaker",36,"Necrophos",242,165,407,0.594594594594595,5.21794871794872
7,"Earthshaker",37,"Warlock",54,45,99,0.545454545454545,1.26923076923077
7,"Earthshaker",38,"Beastmaster",48,34,82,0.585365853658537,1.05128205128205
7,"Earthshaker",39,"Queen of Pain",476,547,1023,0.465298142717498,13.1153846153846
7,"Earthshaker",40,"Venomancer",101,98,199,0.507537688442211,2.55128205128205
7,"Earthshaker",41,"Faceless Void",101,131,232,0.435344827586207,2.97435897435897
7,"Earthshaker",42,"Wraith King",363,282,645,0.562790697674419,8.26923076923077
7,"Earthshaker",43,"Death Prophet",67,67,134,0.5,1.71794871794872
7,"Earthshaker",44,"Phantom Assassin",275,313,588,0.467687074829932,7.53846153846154
7,"Earthshaker",45,"Pugna",42,51,93,0.451612903225806,1.19230769230769
7,"Earthshaker",46,"Templar Assassin",313,291,604,0.518211920529801,7.74358974358974
7,"Earthshaker",47,"Viper",168,145,313,0.536741214057508,4.01282051282051
7,"Earthshaker",48,"Luna",129,107,236,0.546610169491525,3.02564102564103
7,"Earthshaker",49,"Dragon Knight",85,65,150,0.566666666666667,1.92307692307692
7,"Earthshaker",50,"Dazzle",310,274,584,0.530821917808219,7.48717948717949
7,"Earthshaker",51,"Clockwerk",168,173,341,0.49266862170088,4.37179487179487
7,"Earthshaker",52,"Leshrac",40,41,81,0.493827160493827,1.03846153846154
7,"Earthshaker",53,"Nature's Prophet",90,124,214,0.420560747663551,2.74358974358974
7,"Earthshaker",54,"Lifestealer",100,106,206,0.485436893203884,2.64102564102564
7,"Earthshaker",55,"Dark Seer",201,161,362,0.55524861878453,4.64102564102564
7,"Earthshaker",56,"Clinkz",117,126,243,0.481481481481481,3.11538461538462
7,"Earthshaker",57,"Omniknight",185,107,292,0.633561643835616,3.74358974358974
7,"Earthshaker",58,"Enchantress",18,37,55,0.327272727272727,0.705128205128205
7,"Earthshaker",59,"Huskar",146,158,304,0.480263157894737,3.8974358974359
7,"Earthshaker",60,"Night Stalker",112,107,219,0.511415525114155,2.80769230769231
7,"Earthshaker",61,"Broodmother",55,81,136,0.404411764705882,1.74358974358974
7,"Earthshaker",62,"Bounty Hunter",203,204,407,0.498771498771499,5.21794871794872
7,"Earthshaker",63,"Weaver",99,110,209,0.473684210526316,2.67948717948718
7,"Earthshaker",64,"Jakiro",88,73,161,0.546583850931677,2.06410256410256
7,"Earthshaker",65,"Batrider",31,43,74,0.418918918918919,0.948717948717949
7,"Earthshaker",66,"Chen",17,16,33,0.515151515151515,0.423076923076923
7,"Earthshaker",67,"Spectre",362,256,618,0.585760517799353,7.92307692307692
7,"Earthshaker",68,"Ancient Apparition",250,238,488,0.512295081967213,6.25641025641026
7,"Earthshaker",69,"Doom",340,305,645,0.527131782945736,8.26923076923077
7,"Earthshaker",70,"Ursa",201,136,337,0.596439169139466,4.32051282051282
7,"Earthshaker",71,"Spirit Breaker",244,203,447,0.54586129753915,5.73076923076923
7,"Earthshaker",72,"Gyrocopter",405,342,747,0.542168674698795,9.57692307692308
7,"Earthshaker",73,"Alchemist",438,401,839,0.522050059594756,10.7564102564103
7,"Earthshaker",74,"Invoker",472,549,1021,0.462291870714985,13.0897435897436
7,"Earthshaker",75,"Silencer",287,241,528,0.543560606060606,6.76923076923077
7,"Earthshaker",76,"Outworld Devourer",71,65,136,0.522058823529412,1.74358974358974
7,"Earthshaker",77,"Lycan",32,35,67,0.477611940298507,0.858974358974359
7,"Earthshaker",78,"Brewmaster",35,38,73,0.479452054794521,0.935897435897436
7,"Earthshaker",79,"Shadow Demon",37,52,89,0.415730337078652,1.14102564102564
7,"Earthshaker",80,"Lone Druid",28,38,66,0.424242424242424,0.846153846153846
7,"Earthshaker",81,"Chaos Knight",93,109,202,0.46039603960396,2.58974358974359
7,"Earthshaker",82,"Meepo",101,104,205,0.492682926829268,2.62820512820513
7,"Earthshaker",83,"Treant Protector",50,29,79,0.632911392405063,1.01282051282051
7,"Earthshaker",84,"Ogre Magi",91,97,188,0.484042553191489,2.41025641025641
7,"Earthshaker",85,"Undying",212,146,358,0.592178770949721,4.58974358974359
7,"Earthshaker",86,"Rubick",241,284,525,0.459047619047619,6.73076923076923
7,"Earthshaker",87,"Disruptor",184,152,336,0.547619047619048,4.30769230769231
7,"Earthshaker",88,"Nyx Assassin",95,98,193,0.492227979274611,2.47435897435897
7,"Earthshaker",89,"Naga Siren",28,42,70,0.4,0.897435897435897
7,"Earthshaker",90,"Keeper of the Light",65,74,139,0.467625899280576,1.78205128205128
7,"Earthshaker",91,"Io",47,55,102,0.46078431372549,1.30769230769231
7,"Earthshaker",92,"Visage",26,22,48,0.541666666666667,0.615384615384615
7,"Earthshaker",93,"Slark",342,365,707,0.483734087694484,9.06410256410256
7,"Earthshaker",94,"Medusa",120,116,236,0.508474576271186,3.02564102564103
7,"Earthshaker",95,"Troll Warlord",80,87,167,0.479041916167665,2.14102564102564
7,"Earthshaker",96,"Centaur Warrunner",60,46,106,0.566037735849057,1.35897435897436
7,"Earthshaker",97,"Magnus",154,183,337,0.456973293768546,4.32051282051282
7,"Earthshaker",98,"Timbersaw",114,117,231,0.493506493506494,2.96153846153846
7,"Earthshaker",99,"Bristleback",148,176,324,0.45679012345679,4.15384615384615
7,"Earthshaker",100,"Tusk",347,297,644,0.538819875776398,8.25641025641026
7,"Earthshaker",101,"Skywrath Mage",67,118,185,0.362162162162162,2.37179487179487
7,"Earthshaker",102,"Abaddon",122,87,209,0.583732057416268,2.67948717948718
7,"Earthshaker",103,"Elder Titan",33,27,60,0.55,0.769230769230769
7,"Earthshaker",104,"Legion Commander",313,317,630,0.496825396825397,8.07692307692308
7,"Earthshaker",105,"Techies",30,30,60,0.5,0.769230769230769
7,"Earthshaker",106,"Ember Spirit",365,381,746,0.489276139410188,9.56410256410256
7,"Earthshaker",107,"Earth Spirit",103,87,190,0.542105263157895,2.43589743589744
7,"Earthshaker",109,"Terrorblade",62,61,123,0.504065040650406,1.57692307692308
7,"Earthshaker",110,"Phoenix",122,106,228,0.535087719298246,2.92307692307692
7,"Earthshaker",111,"Oracle",24,34,58,0.413793103448276,0.743589743589744
7,"Earthshaker",112,"Winter Wyvern",286,295,581,0.492254733218589,7.44871794871795
8,"Juggernaut",9,"Mirana",310,269,579,0.535405872193437,7.42307692307692
8,"Juggernaut",10,"Morphling",27,50,77,0.350649350649351,0.987179487179487
8,"Juggernaut",11,"Shadow Fiend",785,697,1482,0.529689608636977,19
8,"Juggernaut",12,"Phantom Lancer",31,33,64,0.484375,0.82051282051282
8,"Juggernaut",13,"Puck",50,80,130,0.384615384615385,1.66666666666667
8,"Juggernaut",14,"Pudge",390,397,787,0.495552731893266,10.0897435897436
8,"Juggernaut",15,"Razor",70,60,130,0.538461538461538,1.66666666666667
8,"Juggernaut",16,"Sand King",114,135,249,0.457831325301205,3.19230769230769
8,"Juggernaut",17,"Storm Spirit",67,104,171,0.391812865497076,2.19230769230769
8,"Juggernaut",18,"Sven",52,60,112,0.464285714285714,1.43589743589744
8,"Juggernaut",19,"Tiny",163,148,311,0.52411575562701,3.98717948717949
8,"Juggernaut",20,"Vengeful Spirit",181,157,338,0.535502958579882,4.33333333333333
8,"Juggernaut",21,"Windranger",793,894,1687,0.470065204505039,21.6282051282051
8,"Juggernaut",22,"Zeus",262,167,429,0.610722610722611,5.5
8,"Juggernaut",23,"Kunkka",96,70,166,0.578313253012048,2.12820512820513
8,"Juggernaut",25,"Lina",335,403,738,0.453929539295393,9.46153846153846
8,"Juggernaut",26,"Lion",354,349,703,0.503556187766714,9.01282051282051
8,"Juggernaut",27,"Shadow Shaman",207,181,388,0.533505154639175,4.97435897435897
8,"Juggernaut",28,"Slardar",473,337,810,0.583950617283951,10.3846153846154
8,"Juggernaut",29,"Tidehunter",116,105,221,0.524886877828054,2.83333333333333
8,"Juggernaut",30,"Witch Doctor",309,318,627,0.492822966507177,8.03846153846154
8,"Juggernaut",31,"Lich",247,184,431,0.573085846867749,5.52564102564103
8,"Juggernaut",32,"Riki",156,118,274,0.569343065693431,3.51282051282051
8,"Juggernaut",33,"Enigma",113,100,213,0.530516431924883,2.73076923076923
8,"Juggernaut",34,"Tinker",119,113,232,0.512931034482759,2.97435897435897
8,"Juggernaut",35,"Sniper",94,111,205,0.458536585365854,2.62820512820513
8,"Juggernaut",36,"Necrophos",260,206,466,0.55793991416309,5.97435897435897
8,"Juggernaut",37,"Warlock",95,64,159,0.59748427672956,2.03846153846154
8,"Juggernaut",38,"Beastmaster",56,45,101,0.554455445544555,1.29487179487179
8,"Juggernaut",39,"Queen of Pain",417,496,913,0.456736035049288,11.7051282051282
8,"Juggernaut",40,"Venomancer",143,104,247,0.578947368421053,3.16666666666667
8,"Juggernaut",41,"Faceless Void",36,69,105,0.342857142857143,1.34615384615385
8,"Juggernaut",42,"Wraith King",157,94,251,0.625498007968127,3.21794871794872
8,"Juggernaut",43,"Death Prophet",73,53,126,0.579365079365079,1.61538461538462
8,"Juggernaut",44,"Phantom Assassin",78,135,213,0.366197183098592,2.73076923076923
8,"Juggernaut",45,"Pugna",54,53,107,0.504672897196262,1.37179487179487
8,"Juggernaut",46,"Templar Assassin",252,221,473,0.53276955602537,6.06410256410256
8,"Juggernaut",47,"Viper",139,138,277,0.501805054151625,3.55128205128205
8,"Juggernaut",48,"Luna",36,34,70,0.514285714285714,0.897435897435897
8,"Juggernaut",49,"Dragon Knight",63,54,117,0.538461538461538,1.5
8,"Juggernaut",50,"Dazzle",347,330,677,0.512555391432792,8.67948717948718
8,"Juggernaut",51,"Clockwerk",202,192,394,0.512690355329949,5.05128205128205
8,"Juggernaut",52,"Leshrac",45,53,98,0.459183673469388,1.25641025641026
8,"Juggernaut",53,"Nature's Prophet",96,148,244,0.39344262295082,3.12820512820513
8,"Juggernaut",54,"Lifestealer",63,76,139,0.453237410071942,1.78205128205128
8,"Juggernaut",55,"Dark Seer",188,142,330,0.56969696969697,4.23076923076923
8,"Juggernaut",56,"Clinkz",52,65,117,0.444444444444444,1.5
8,"Juggernaut",57,"Omniknight",197,146,343,0.574344023323615,4.3974358974359
8,"Juggernaut",58,"Enchantress",23,43,66,0.348484848484849,0.846153846153846
8,"Juggernaut",59,"Huskar",108,116,224,0.482142857142857,2.87179487179487
8,"Juggernaut",60,"Night Stalker",149,107,256,0.58203125,3.28205128205128
8,"Juggernaut",61,"Broodmother",52,58,110,0.472727272727273,1.41025641025641
8,"Juggernaut",62,"Bounty Hunter",280,284,564,0.49645390070922,7.23076923076923
8,"Juggernaut",63,"Weaver",65,89,154,0.422077922077922,1.97435897435897
8,"Juggernaut",64,"Jakiro",127,114,241,0.526970954356846,3.08974358974359
8,"Juggernaut",65,"Batrider",50,64,114,0.43859649122807,1.46153846153846
8,"Juggernaut",66,"Chen",24,21,45,0.533333333333333,0.576923076923077
8,"Juggernaut",67,"Spectre",74,55,129,0.573643410852713,1.65384615384615
8,"Juggernaut",68,"Ancient Apparition",330,267,597,0.552763819095477,7.65384615384615
8,"Juggernaut",69,"Doom",365,296,661,0.552193645990923,8.47435897435897
8,"Juggernaut",70,"Ursa",120,101,221,0.542986425339366,2.83333333333333
8,"Juggernaut",71,"Spirit Breaker",368,266,634,0.580441640378549,8.12820512820513
8,"Juggernaut",72,"Gyrocopter",82,85,167,0.491017964071856,2.14102564102564
8,"Juggernaut",73,"Alchemist",390,325,715,0.545454545454545,9.16666666666667
8,"Juggernaut",74,"Invoker",459,455,914,0.50218818380744,11.7179487179487
8,"Juggernaut",75,"Silencer",309,278,587,0.526405451448041,7.52564102564103
8,"Juggernaut",76,"Outworld Devourer",50,62,112,0.446428571428571,1.43589743589744
8,"Juggernaut",77,"Lycan",22,26,48,0.458333333333333,0.615384615384615
8,"Juggernaut",78,"Brewmaster",40,34,74,0.540540540540541,0.948717948717949
8,"Juggernaut",79,"Shadow Demon",52,57,109,0.477064220183486,1.3974358974359
8,"Juggernaut",80,"Lone Druid",39,27,66,0.590909090909091,0.846153846153846
8,"Juggernaut",81,"Chaos Knight",39,45,84,0.464285714285714,1.07692307692308
8,"Juggernaut",82,"Meepo",50,42,92,0.543478260869565,1.17948717948718
8,"Juggernaut",83,"Treant Protector",75,65,140,0.535714285714286,1.79487179487179
8,"Juggernaut",84,"Ogre Magi",197,178,375,0.525333333333333,4.80769230769231
8,"Juggernaut",85,"Undying",285,207,492,0.579268292682927,6.30769230769231
8,"Juggernaut",86,"Rubick",375,413,788,0.475888324873096,10.1025641025641
8,"Juggernaut",87,"Disruptor",221,190,411,0.537712895377129,5.26923076923077
8,"Juggernaut",88,"Nyx Assassin",101,113,214,0.47196261682243,2.74358974358974
8,"Juggernaut",89,"Naga Siren",29,31,60,0.483333333333333,0.769230769230769
8,"Juggernaut",90,"Keeper of the Light",77,74,151,0.509933774834437,1.93589743589744
8,"Juggernaut",91,"Io",52,60,112,0.464285714285714,1.43589743589744
8,"Juggernaut",92,"Visage",42,34,76,0.552631578947368,0.974358974358974
8,"Juggernaut",93,"Slark",120,140,260,0.461538461538462,3.33333333333333
8,"Juggernaut",94,"Medusa",46,53,99,0.464646464646465,1.26923076923077
8,"Juggernaut",95,"Troll Warlord",19,40,59,0.322033898305085,0.756410256410256
8,"Juggernaut",96,"Centaur Warrunner",84,72,156,0.538461538461538,2
8,"Juggernaut",97,"Magnus",170,145,315,0.53968253968254,4.03846153846154
8,"Juggernaut",98,"Timbersaw",104,111,215,0.483720930232558,2.75641025641026
8,"Juggernaut",99,"Bristleback",145,154,299,0.48494983277592,3.83333333333333
8,"Juggernaut",100,"Tusk",448,430,878,0.510250569476082,11.2564102564103
8,"Juggernaut",101,"Skywrath Mage",118,135,253,0.466403162055336,3.24358974358974
8,"Juggernaut",102,"Abaddon",155,93,248,0.625,3.17948717948718
8,"Juggernaut",103,"Elder Titan",34,24,58,0.586206896551724,0.743589743589744
8,"Juggernaut",104,"Legion Commander",255,296,551,0.462794918330309,7.06410256410256
8,"Juggernaut",105,"Techies",44,49,93,0.473118279569892,1.19230769230769
8,"Juggernaut",106,"Ember Spirit",210,187,397,0.52896725440806,5.08974358974359
8,"Juggernaut",107,"Earth Spirit",150,114,264,0.568181818181818,3.38461538461538
8,"Juggernaut",109,"Terrorblade",29,30,59,0.491525423728814,0.756410256410256
8,"Juggernaut",110,"Phoenix",144,123,267,0.539325842696629,3.42307692307692
8,"Juggernaut",111,"Oracle",47,37,84,0.55952380952381,1.07692307692308
8,"Juggernaut",112,"Winter Wyvern",384,316,700,0.548571428571429,8.97435897435897
9,"Mirana",10,"Morphling",46,41,87,0.528735632183908,1.11538461538462
9,"Mirana",11,"Shadow Fiend",534,443,977,0.546571136131013,12.525641025641
9,"Mirana",12,"Phantom Lancer",84,103,187,0.449197860962567,2.3974358974359
9,"Mirana",13,"Puck",45,56,101,0.445544554455446,1.29487179487179
9,"Mirana",14,"Pudge",253,271,524,0.482824427480916,6.71794871794872
9,"Mirana",15,"Razor",50,44,94,0.531914893617021,1.20512820512821
9,"Mirana",16,"Sand King",76,69,145,0.524137931034483,1.85897435897436
9,"Mirana",17,"Storm Spirit",62,73,135,0.459259259259259,1.73076923076923
9,"Mirana",18,"Sven",101,76,177,0.570621468926554,2.26923076923077
9,"Mirana",19,"Tiny",130,163,293,0.443686006825939,3.75641025641026
9,"Mirana",20,"Vengeful Spirit",79,79,158,0.5,2.02564102564103
9,"Mirana",21,"Windranger",544,531,1075,0.506046511627907,13.7820512820513
9,"Mirana",22,"Zeus",148,85,233,0.63519313304721,2.98717948717949
9,"Mirana",23,"Kunkka",77,73,150,0.513333333333333,1.92307692307692
9,"Mirana",25,"Lina",163,202,365,0.446575342465753,4.67948717948718
9,"Mirana",26,"Lion",165,161,326,0.506134969325153,4.17948717948718
9,"Mirana",27,"Shadow Shaman",78,78,156,0.5,2
9,"Mirana",28,"Slardar",315,255,570,0.552631578947368,7.30769230769231
9,"Mirana",29,"Tidehunter",86,53,139,0.618705035971223,1.78205128205128
9,"Mirana",30,"Witch Doctor",152,140,292,0.520547945205479,3.74358974358974
9,"Mirana",31,"Lich",92,76,168,0.547619047619048,2.15384615384615
9,"Mirana",32,"Riki",103,89,192,0.536458333333333,2.46153846153846
9,"Mirana",33,"Enigma",54,42,96,0.5625,1.23076923076923
9,"Mirana",34,"Tinker",91,73,164,0.554878048780488,2.1025641025641
9,"Mirana",35,"Sniper",80,93,173,0.46242774566474,2.21794871794872
9,"Mirana",36,"Necrophos",175,118,293,0.597269624573379,3.75641025641026
9,"Mirana",37,"Warlock",46,31,77,0.597402597402597,0.987179487179487
9,"Mirana",38,"Beastmaster",34,27,61,0.557377049180328,0.782051282051282
9,"Mirana",39,"Queen of Pain",242,300,542,0.446494464944649,6.94871794871795
9,"Mirana",40,"Venomancer",63,51,114,0.552631578947368,1.46153846153846
9,"Mirana",41,"Faceless Void",95,108,203,0.467980295566502,2.6025641025641
9,"Mirana",42,"Wraith King",258,169,427,0.604215456674473,5.47435897435897
9,"Mirana",43,"Death Prophet",46,44,90,0.511111111111111,1.15384615384615
9,"Mirana",44,"Phantom Assassin",214,205,419,0.510739856801909,5.37179487179487
9,"Mirana",45,"Pugna",36,39,75,0.48,0.961538461538462
9,"Mirana",46,"Templar Assassin",153,172,325,0.470769230769231,4.16666666666667
9,"Mirana",47,"Viper",73,76,149,0.48993288590604,1.91025641025641
9,"Mirana",48,"Luna",61,64,125,0.488,1.6025641025641
9,"Mirana",49,"Dragon Knight",58,46,104,0.557692307692308,1.33333333333333
9,"Mirana",50,"Dazzle",178,147,325,0.547692307692308,4.16666666666667
9,"Mirana",51,"Clockwerk",142,109,251,0.565737051792829,3.21794871794872
9,"Mirana",52,"Leshrac",26,27,53,0.490566037735849,0.67948717948718
9,"Mirana",53,"Nature's Prophet",52,83,135,0.385185185185185,1.73076923076923
9,"Mirana",54,"Lifestealer",67,75,142,0.471830985915493,1.82051282051282
9,"Mirana",55,"Dark Seer",86,87,173,0.497109826589595,2.21794871794872
9,"Mirana",56,"Clinkz",44,57,101,0.435643564356436,1.29487179487179
9,"Mirana",57,"Omniknight",133,108,241,0.551867219917012,3.08974358974359
9,"Mirana",58,"Enchantress",16,28,44,0.363636363636364,0.564102564102564
9,"Mirana",59,"Huskar",83,83,166,0.5,2.12820512820513
9,"Mirana",60,"Night Stalker",72,74,146,0.493150684931507,1.87179487179487
9,"Mirana",61,"Broodmother",25,35,60,0.416666666666667,0.769230769230769
9,"Mirana",62,"Bounty Hunter",130,128,258,0.503875968992248,3.30769230769231
9,"Mirana",63,"Weaver",50,67,117,0.427350427350427,1.5
9,"Mirana",64,"Jakiro",58,49,107,0.542056074766355,1.37179487179487
9,"Mirana",65,"Batrider",28,31,59,0.474576271186441,0.756410256410256
9,"Mirana",66,"Chen",13,10,23,0.565217391304348,0.294871794871795
9,"Mirana",67,"Spectre",260,156,416,0.625,5.33333333333333
9,"Mirana",68,"Ancient Apparition",133,144,277,0.48014440433213,3.55128205128205
9,"Mirana",69,"Doom",208,160,368,0.565217391304348,4.71794871794872
9,"Mirana",70,"Ursa",136,104,240,0.566666666666667,3.07692307692308
9,"Mirana",71,"Spirit Breaker",164,129,293,0.559726962457338,3.75641025641026
9,"Mirana",72,"Gyrocopter",180,171,351,0.512820512820513,4.5
9,"Mirana",73,"Alchemist",319,259,578,0.551903114186851,7.41025641025641
9,"Mirana",74,"Invoker",311,341,652,0.476993865030675,8.35897435897436
9,"Mirana",75,"Silencer",182,158,340,0.535294117647059,4.35897435897436
9,"Mirana",76,"Outworld Devourer",38,39,77,0.493506493506494,0.987179487179487
9,"Mirana",77,"Lycan",32,11,43,0.744186046511628,0.551282051282051
9,"Mirana",78,"Brewmaster",43,23,66,0.651515151515151,0.846153846153846
9,"Mirana",79,"Shadow Demon",37,54,91,0.406593406593407,1.16666666666667
9,"Mirana",80,"Lone Druid",22,28,50,0.44,0.641025641025641
9,"Mirana",81,"Chaos Knight",60,68,128,0.46875,1.64102564102564
9,"Mirana",82,"Meepo",44,38,82,0.536585365853659,1.05128205128205
9,"Mirana",83,"Treant Protector",31,35,66,0.46969696969697,0.846153846153846
9,"Mirana",84,"Ogre Magi",117,95,212,0.55188679245283,2.71794871794872
9,"Mirana",85,"Undying",142,104,246,0.577235772357724,3.15384615384615
9,"Mirana",86,"Rubick",151,191,342,0.441520467836257,4.38461538461539
9,"Mirana",87,"Disruptor",95,87,182,0.521978021978022,2.33333333333333
9,"Mirana",88,"Nyx Assassin",69,59,128,0.5390625,1.64102564102564
9,"Mirana",89,"Naga Siren",22,30,52,0.423076923076923,0.666666666666667
9,"Mirana",90,"Keeper of the Light",43,45,88,0.488636363636364,1.12820512820513
9,"Mirana",91,"Io",28,32,60,0.466666666666667,0.769230769230769
9,"Mirana",92,"Visage",18,18,36,0.5,0.461538461538462
9,"Mirana",93,"Slark",227,227,454,0.5,5.82051282051282
9,"Mirana",94,"Medusa",67,67,134,0.5,1.71794871794872
9,"Mirana",95,"Troll Warlord",39,48,87,0.448275862068966,1.11538461538462
9,"Mirana",96,"Centaur Warrunner",52,43,95,0.547368421052632,1.21794871794872
9,"Mirana",97,"Magnus",92,93,185,0.497297297297297,2.37179487179487
9,"Mirana",98,"Timbersaw",67,96,163,0.411042944785276,2.08974358974359
9,"Mirana",99,"Bristleback",98,100,198,0.494949494949495,2.53846153846154
9,"Mirana",100,"Tusk",233,206,439,0.530751708428246,5.62820512820513
9,"Mirana",101,"Skywrath Mage",49,56,105,0.466666666666667,1.34615384615385
9,"Mirana",102,"Abaddon",85,61,146,0.582191780821918,1.87179487179487
9,"Mirana",103,"Elder Titan",17,13,30,0.566666666666667,0.384615384615385
9,"Mirana",104,"Legion Commander",213,241,454,0.469162995594714,5.82051282051282
9,"Mirana",105,"Techies",21,19,40,0.525,0.512820512820513
9,"Mirana",106,"Ember Spirit",252,225,477,0.528301886792453,6.11538461538461
9,"Mirana",107,"Earth Spirit",59,60,119,0.495798319327731,1.52564102564103
9,"Mirana",109,"Terrorblade",44,41,85,0.517647058823529,1.08974358974359
9,"Mirana",110,"Phoenix",80,52,132,0.606060606060606,1.69230769230769
9,"Mirana",111,"Oracle",27,17,44,0.613636363636364,0.564102564102564
9,"Mirana",112,"Winter Wyvern",157,148,305,0.514754098360656,3.91025641025641
10,"Morphling",11,"Shadow Fiend",73,102,175,0.417142857142857,2.24358974358974
10,"Morphling",12,"Phantom Lancer",9,11,20,0.45,0.256410256410256
10,"Morphling",13,"Puck",4,8,12,0.333333333333333,0.153846153846154
10,"Morphling",14,"Pudge",48,70,118,0.406779661016949,1.51282051282051
10,"Morphling",15,"Razor",7,12,19,0.368421052631579,0.243589743589744
10,"Morphling",16,"Sand King",22,24,46,0.478260869565217,0.58974358974359
10,"Morphling",17,"Storm Spirit",10,16,26,0.384615384615385,0.333333333333333
10,"Morphling",18,"Sven",12,13,25,0.48,0.320512820512821
10,"Morphling",19,"Tiny",22,34,56,0.392857142857143,0.717948717948718
10,"Morphling",20,"Vengeful Spirit",31,28,59,0.525423728813559,0.756410256410256
10,"Morphling",21,"Windranger",94,116,210,0.447619047619048,2.69230769230769
10,"Morphling",22,"Zeus",19,29,48,0.395833333333333,0.615384615384615
10,"Morphling",23,"Kunkka",2,11,13,0.153846153846154,0.166666666666667
10,"Morphling",25,"Lina",31,66,97,0.319587628865979,1.24358974358974
10,"Morphling",26,"Lion",35,52,87,0.402298850574713,1.11538461538462
10,"Morphling",27,"Shadow Shaman",20,25,45,0.444444444444444,0.576923076923077
10,"Morphling",28,"Slardar",49,64,113,0.433628318584071,1.44871794871795
10,"Morphling",29,"Tidehunter",10,12,22,0.454545454545455,0.282051282051282
10,"Morphling",30,"Witch Doctor",45,36,81,0.555555555555556,1.03846153846154
10,"Morphling",31,"Lich",22,34,56,0.392857142857143,0.717948717948718
10,"Morphling",32,"Riki",18,17,35,0.514285714285714,0.448717948717949
10,"Morphling",33,"Enigma",15,15,30,0.5,0.384615384615385
10,"Morphling",34,"Tinker",11,18,29,0.379310344827586,0.371794871794872
10,"Morphling",35,"Sniper",11,20,31,0.354838709677419,0.397435897435897
10,"Morphling",36,"Necrophos",32,34,66,0.484848484848485,0.846153846153846
10,"Morphling",37,"Warlock",10,14,24,0.416666666666667,0.307692307692308
10,"Morphling",38,"Beastmaster",5,8,13,0.384615384615385,0.166666666666667
10,"Morphling",39,"Queen of Pain",33,65,98,0.336734693877551,1.25641025641026
10,"Morphling",40,"Venomancer",12,15,27,0.444444444444444,0.346153846153846
10,"Morphling",41,"Faceless Void",10,13,23,0.434782608695652,0.294871794871795
10,"Morphling",42,"Wraith King",29,25,54,0.537037037037037,0.692307692307692
10,"Morphling",43,"Death Prophet",4,10,14,0.285714285714286,0.179487179487179
10,"Morphling",44,"Phantom Assassin",19,37,56,0.339285714285714,0.717948717948718
10,"Morphling",45,"Pugna",6,8,14,0.428571428571429,0.179487179487179
10,"Morphling",46,"Templar Assassin",31,32,63,0.492063492063492,0.807692307692308
10,"Morphling",47,"Viper",15,19,34,0.441176470588235,0.435897435897436
10,"Morphling",48,"Luna",13,13,26,0.5,0.333333333333333
10,"Morphling",49,"Dragon Knight",10,12,22,0.454545454545455,0.282051282051282
10,"Morphling",50,"Dazzle",37,65,102,0.362745098039216,1.30769230769231
10,"Morphling",51,"Clockwerk",26,37,63,0.412698412698413,0.807692307692308
10,"Morphling",52,"Leshrac",5,9,14,0.357142857142857,0.179487179487179
10,"Morphling",53,"Nature's Prophet",12,21,33,0.363636363636364,0.423076923076923
10,"Morphling",54,"Lifestealer",8,6,14,0.571428571428571,0.179487179487179
10,"Morphling",55,"Dark Seer",19,27,46,0.41304347826087,0.58974358974359
10,"Morphling",56,"Clinkz",9,12,21,0.428571428571429,0.269230769230769
10,"Morphling",57,"Omniknight",28,25,53,0.528301886792453,0.67948717948718
10,"Morphling",58,"Enchantress",1,7,8,0.125,0.102564102564103
10,"Morphling",59,"Huskar",16,19,35,0.457142857142857,0.448717948717949
10,"Morphling",60,"Night Stalker",17,18,35,0.485714285714286,0.448717948717949
10,"Morphling",61,"Broodmother",4,12,16,0.25,0.205128205128205
10,"Morphling",62,"Bounty Hunter",33,43,76,0.434210526315789,0.974358974358974
10,"Morphling",63,"Weaver",6,17,23,0.260869565217391,0.294871794871795
10,"Morphling",64,"Jakiro",11,15,26,0.423076923076923,0.333333333333333
10,"Morphling",65,"Batrider",4,8,12,0.333333333333333,0.153846153846154
10,"Morphling",66,"Chen",1,4,5,0.2,0.0641025641025641
10,"Morphling",67,"Spectre",23,23,46,0.5,0.58974358974359
10,"Morphling",68,"Ancient Apparition",25,43,68,0.367647058823529,0.871794871794872
10,"Morphling",69,"Doom",39,45,84,0.464285714285714,1.07692307692308
10,"Morphling",70,"Ursa",21,22,43,0.488372093023256,0.551282051282051
10,"Morphling",71,"Spirit Breaker",35,46,81,0.432098765432099,1.03846153846154
10,"Morphling",72,"Gyrocopter",24,34,58,0.413793103448276,0.743589743589744
10,"Morphling",73,"Alchemist",58,75,133,0.43609022556391,1.70512820512821
10,"Morphling",74,"Invoker",58,51,109,0.532110091743119,1.3974358974359
10,"Morphling",75,"Silencer",42,46,88,0.477272727272727,1.12820512820513
10,"Morphling",76,"Outworld Devourer",6,12,18,0.333333333333333,0.230769230769231
10,"Morphling",77,"Lycan",4,3,7,0.571428571428571,0.0897435897435897
10,"Morphling",78,"Brewmaster",6,11,17,0.352941176470588,0.217948717948718
10,"Morphling",79,"Shadow Demon",3,10,13,0.230769230769231,0.166666666666667
10,"Morphling",80,"Lone Druid",6,6,12,0.5,0.153846153846154
10,"Morphling",81,"Chaos Knight",8,7,15,0.533333333333333,0.192307692307692
10,"Morphling",82,"Meepo",6,14,20,0.3,0.256410256410256
10,"Morphling",83,"Treant Protector",10,10,20,0.5,0.256410256410256
10,"Morphling",84,"Ogre Magi",26,24,50,0.52,0.641025641025641
10,"Morphling",85,"Undying",32,39,71,0.450704225352113,0.91025641025641
10,"Morphling",86,"Rubick",33,59,92,0.358695652173913,1.17948717948718
10,"Morphling",87,"Disruptor",21,24,45,0.466666666666667,0.576923076923077
10,"Morphling",88,"Nyx Assassin",17,19,36,0.472222222222222,0.461538461538462
10,"Morphling",89,"Naga Siren",2,6,8,0.25,0.102564102564103
10,"Morphling",90,"Keeper of the Light",7,11,18,0.388888888888889,0.230769230769231
10,"Morphling",91,"Io",7,14,21,0.333333333333333,0.269230769230769
10,"Morphling",92,"Visage",6,5,11,0.545454545454545,0.141025641025641
10,"Morphling",93,"Slark",24,39,63,0.380952380952381,0.807692307692308
10,"Morphling",94,"Medusa",7,8,15,0.466666666666667,0.192307692307692
10,"Morphling",95,"Troll Warlord",4,13,17,0.235294117647059,0.217948717948718
10,"Morphling",96,"Centaur Warrunner",8,11,19,0.421052631578947,0.243589743589744
10,"Morphling",97,"Magnus",13,18,31,0.419354838709677,0.397435897435897
10,"Morphling",98,"Timbersaw",15,15,30,0.5,0.384615384615385
10,"Morphling",99,"Bristleback",21,26,47,0.446808510638298,0.602564102564103
10,"Morphling",100,"Tusk",55,54,109,0.504587155963303,1.3974358974359
10,"Morphling",101,"Skywrath Mage",10,22,32,0.3125,0.41025641025641
10,"Morphling",102,"Abaddon",17,27,44,0.386363636363636,0.564102564102564
10,"Morphling",103,"Elder Titan",4,7,11,0.363636363636364,0.141025641025641
10,"Morphling",104,"Legion Commander",35,61,96,0.364583333333333,1.23076923076923
10,"Morphling",105,"Techies",6,2,8,0.75,0.102564102564103
10,"Morphling",106,"Ember Spirit",28,34,62,0.451612903225806,0.794871794871795
10,"Morphling",107,"Earth Spirit",12,21,33,0.363636363636364,0.423076923076923
10,"Morphling",109,"Terrorblade",0,7,7,0,0.0897435897435897
10,"Morphling",110,"Phoenix",12,12,24,0.5,0.307692307692308
10,"Morphling",111,"Oracle",5,8,13,0.384615384615385,0.166666666666667
10,"Morphling",112,"Winter Wyvern",44,40,84,0.523809523809524,1.07692307692308
11,"Shadow Fiend",12,"Phantom Lancer",204,248,452,0.451327433628319,5.79487179487179
11,"Shadow Fiend",13,"Puck",49,74,123,0.398373983739837,1.57692307692308
11,"Shadow Fiend",14,"Pudge",468,450,918,0.509803921568627,11.7692307692308
11,"Shadow Fiend",15,"Razor",87,82,169,0.514792899408284,2.16666666666667
11,"Shadow Fiend",16,"Sand King",237,218,455,0.520879120879121,5.83333333333333
11,"Shadow Fiend",17,"Storm Spirit",39,54,93,0.419354838709677,1.19230769230769
11,"Shadow Fiend",18,"Sven",226,207,433,0.521939953810624,5.55128205128205
11,"Shadow Fiend",19,"Tiny",223,257,480,0.464583333333333,6.15384615384615
11,"Shadow Fiend",20,"Vengeful Spirit",354,309,663,0.53393665158371,8.5
11,"Shadow Fiend",21,"Windranger",784,905,1689,0.464179988158674,21.6538461538462
11,"Shadow Fiend",22,"Zeus",168,116,284,0.591549295774648,3.64102564102564
11,"Shadow Fiend",23,"Kunkka",114,142,256,0.4453125,3.28205128205128
11,"Shadow Fiend",25,"Lina",289,403,692,0.417630057803468,8.87179487179487
11,"Shadow Fiend",26,"Lion",527,528,1055,0.499526066350711,13.525641025641
11,"Shadow Fiend",27,"Shadow Shaman",262,212,474,0.552742616033755,6.07692307692308
11,"Shadow Fiend",28,"Slardar",1023,776,1799,0.568649249583102,23.0641025641026
11,"Shadow Fiend",29,"Tidehunter",188,168,356,0.528089887640449,4.56410256410256
11,"Shadow Fiend",30,"Witch Doctor",539,438,977,0.551688843398158,12.525641025641
11,"Shadow Fiend",31,"Lich",384,301,685,0.560583941605839,8.78205128205128
11,"Shadow Fiend",32,"Riki",276,226,502,0.549800796812749,6.43589743589744
11,"Shadow Fiend",33,"Enigma",191,195,386,0.494818652849741,4.94871794871795
11,"Shadow Fiend",34,"Tinker",40,42,82,0.48780487804878,1.05128205128205
11,"Shadow Fiend",35,"Sniper",132,161,293,0.450511945392491,3.75641025641026
11,"Shadow Fiend",36,"Necrophos",410,284,694,0.590778097982709,8.8974358974359
11,"Shadow Fiend",37,"Warlock",127,91,218,0.582568807339449,2.79487179487179
11,"Shadow Fiend",38,"Beastmaster",90,65,155,0.580645161290323,1.98717948717949
11,"Shadow Fiend",39,"Queen of Pain",232,302,534,0.434456928838951,6.84615384615385
11,"Shadow Fiend",40,"Venomancer",191,170,361,0.529085872576177,4.62820512820513
11,"Shadow Fiend",41,"Faceless Void",167,181,348,0.479885057471264,4.46153846153846
11,"Shadow Fiend",42,"Wraith King",739,428,1167,0.63324764353042,14.9615384615385
11,"Shadow Fiend",43,"Death Prophet",60,51,111,0.540540540540541,1.42307692307692
11,"Shadow Fiend",44,"Phantom Assassin",420,419,839,0.500595947556615,10.7564102564103
11,"Shadow Fiend",45,"Pugna",93,100,193,0.481865284974093,2.47435897435897
11,"Shadow Fiend",46,"Templar Assassin",53,60,113,0.469026548672566,1.44871794871795
11,"Shadow Fiend",47,"Viper",149,107,256,0.58203125,3.28205128205128
11,"Shadow Fiend",48,"Luna",155,122,277,0.55956678700361,3.55128205128205
11,"Shadow Fiend",49,"Dragon Knight",80,66,146,0.547945205479452,1.87179487179487
11,"Shadow Fiend",50,"Dazzle",715,579,1294,0.552550231839258,16.5897435897436
11,"Shadow Fiend",51,"Clockwerk",357,285,642,0.55607476635514,8.23076923076923
11,"Shadow Fiend",52,"Leshrac",45,65,110,0.409090909090909,1.41025641025641
11,"Shadow Fiend",53,"Nature's Prophet",173,263,436,0.396788990825688,5.58974358974359
11,"Shadow Fiend",54,"Lifestealer",154,140,294,0.523809523809524,3.76923076923077
11,"Shadow Fiend",55,"Dark Seer",355,354,709,0.500705218617772,9.08974358974359
11,"Shadow Fiend",56,"Clinkz",145,150,295,0.491525423728814,3.78205128205128
11,"Shadow Fiend",57,"Omniknight",414,285,699,0.592274678111588,8.96153846153846
11,"Shadow Fiend",58,"Enchantress",59,61,120,0.491666666666667,1.53846153846154
11,"Shadow Fiend",59,"Huskar",217,187,404,0.537128712871287,5.17948717948718
11,"Shadow Fiend",60,"Night Stalker",195,182,377,0.517241379310345,4.83333333333333
11,"Shadow Fiend",61,"Broodmother",85,105,190,0.447368421052632,2.43589743589744
11,"Shadow Fiend",62,"Bounty Hunter",501,505,1006,0.498011928429423,12.8974358974359
11,"Shadow Fiend",63,"Weaver",130,144,274,0.474452554744526,3.51282051282051
11,"Shadow Fiend",64,"Jakiro",195,180,375,0.52,4.80769230769231
11,"Shadow Fiend",65,"Batrider",67,72,139,0.482014388489209,1.78205128205128
11,"Shadow Fiend",66,"Chen",35,43,78,0.448717948717949,1
11,"Shadow Fiend",67,"Spectre",515,351,866,0.594688221709007,11.1025641025641
11,"Shadow Fiend",68,"Ancient Apparition",502,470,972,0.516460905349794,12.4615384615385
11,"Shadow Fiend",69,"Doom",664,562,1226,0.541598694942904,15.7179487179487
11,"Shadow Fiend",70,"Ursa",276,200,476,0.579831932773109,6.1025641025641
11,"Shadow Fiend",71,"Spirit Breaker",637,454,1091,0.583868010999083,13.9871794871795
11,"Shadow Fiend",72,"Gyrocopter",444,425,869,0.510932105868815,11.1410256410256
11,"Shadow Fiend",73,"Alchemist",263,286,549,0.479052823315118,7.03846153846154
11,"Shadow Fiend",74,"Invoker",283,297,580,0.487931034482759,7.43589743589744
11,"Shadow Fiend",75,"Silencer",510,429,939,0.543130990415335,12.0384615384615
11,"Shadow Fiend",76,"Outworld Devourer",33,44,77,0.428571428571429,0.987179487179487
11,"Shadow Fiend",77,"Lycan",57,66,123,0.463414634146341,1.57692307692308
11,"Shadow Fiend",78,"Brewmaster",46,46,92,0.5,1.17948717948718
11,"Shadow Fiend",79,"Shadow Demon",82,124,206,0.398058252427184,2.64102564102564
11,"Shadow Fiend",80,"Lone Druid",56,64,120,0.466666666666667,1.53846153846154
11,"Shadow Fiend",81,"Chaos Knight",139,129,268,0.51865671641791,3.43589743589744
11,"Shadow Fiend",82,"Meepo",71,77,148,0.47972972972973,1.8974358974359
11,"Shadow Fiend",83,"Treant Protector",123,108,231,0.532467532467532,2.96153846153846
11,"Shadow Fiend",84,"Ogre Magi",316,269,585,0.54017094017094,7.5
11,"Shadow Fiend",85,"Undying",465,344,809,0.574783683559951,10.3717948717949
11,"Shadow Fiend",86,"Rubick",581,633,1214,0.478583196046128,15.5641025641026
11,"Shadow Fiend",87,"Disruptor",381,345,726,0.524793388429752,9.30769230769231
11,"Shadow Fiend",88,"Nyx Assassin",168,179,347,0.484149855907781,4.44871794871795
11,"Shadow Fiend",89,"Naga Siren",53,67,120,0.441666666666667,1.53846153846154
11,"Shadow Fiend",90,"Keeper of the Light",137,134,271,0.505535055350554,3.47435897435897
11,"Shadow Fiend",91,"Io",126,103,229,0.550218340611354,2.93589743589744
11,"Shadow Fiend",92,"Visage",70,59,129,0.542635658914729,1.65384615384615
11,"Shadow Fiend",93,"Slark",603,603,1206,0.5,15.4615384615385
11,"Shadow Fiend",94,"Medusa",138,105,243,0.567901234567901,3.11538461538462
11,"Shadow Fiend",95,"Troll Warlord",100,79,179,0.558659217877095,2.29487179487179
11,"Shadow Fiend",96,"Centaur Warrunner",146,105,251,0.581673306772908,3.21794871794872
11,"Shadow Fiend",97,"Magnus",162,213,375,0.432,4.80769230769231
11,"Shadow Fiend",98,"Timbersaw",179,194,373,0.479892761394102,4.78205128205128
11,"Shadow Fiend",99,"Bristleback",257,242,499,0.51503006012024,6.3974358974359
11,"Shadow Fiend",100,"Tusk",807,751,1558,0.517971758664955,19.974358974359
11,"Shadow Fiend",101,"Skywrath Mage",186,202,388,0.479381443298969,4.97435897435897
11,"Shadow Fiend",102,"Abaddon",271,168,439,0.617312072892939,5.62820512820513
11,"Shadow Fiend",103,"Elder Titan",61,49,110,0.554545454545455,1.41025641025641
11,"Shadow Fiend",104,"Legion Commander",551,489,1040,0.529807692307692,13.3333333333333
11,"Shadow Fiend",105,"Techies",59,82,141,0.418439716312057,1.80769230769231
11,"Shadow Fiend",106,"Ember Spirit",281,309,590,0.476271186440678,7.56410256410256
11,"Shadow Fiend",107,"Earth Spirit",254,181,435,0.583908045977012,5.57692307692308
11,"Shadow Fiend",109,"Terrorblade",93,95,188,0.49468085106383,2.41025641025641
11,"Shadow Fiend",110,"Phoenix",256,187,443,0.577878103837472,5.67948717948718
11,"Shadow Fiend",111,"Oracle",67,67,134,0.5,1.71794871794872
11,"Shadow Fiend",112,"Winter Wyvern",667,581,1248,0.534455128205128,16
12,"Phantom Lancer",13,"Puck",11,33,44,0.25,0.564102564102564
12,"Phantom Lancer",14,"Pudge",112,136,248,0.451612903225806,3.17948717948718
12,"Phantom Lancer",15,"Razor",18,18,36,0.5,0.461538461538462
12,"Phantom Lancer",16,"Sand King",26,56,82,0.317073170731707,1.05128205128205
12,"Phantom Lancer",17,"Storm Spirit",24,43,67,0.358208955223881,0.858974358974359
12,"Phantom Lancer",18,"Sven",17,27,44,0.386363636363636,0.564102564102564
12,"Phantom Lancer",19,"Tiny",44,58,102,0.431372549019608,1.30769230769231
12,"Phantom Lancer",20,"Vengeful Spirit",67,66,133,0.503759398496241,1.70512820512821
12,"Phantom Lancer",21,"Windranger",249,342,591,0.421319796954315,7.57692307692308
12,"Phantom Lancer",22,"Zeus",69,53,122,0.565573770491803,1.56410256410256
12,"Phantom Lancer",23,"Kunkka",24,32,56,0.428571428571429,0.717948717948718
12,"Phantom Lancer",25,"Lina",84,152,236,0.355932203389831,3.02564102564103
12,"Phantom Lancer",26,"Lion",85,152,237,0.358649789029536,3.03846153846154
12,"Phantom Lancer",27,"Shadow Shaman",54,53,107,0.504672897196262,1.37179487179487
12,"Phantom Lancer",28,"Slardar",119,116,235,0.506382978723404,3.01282051282051
12,"Phantom Lancer",29,"Tidehunter",31,28,59,0.525423728813559,0.756410256410256
12,"Phantom Lancer",30,"Witch Doctor",100,142,242,0.413223140495868,3.1025641025641
12,"Phantom Lancer",31,"Lich",92,71,163,0.56441717791411,2.08974358974359
12,"Phantom Lancer",32,"Riki",48,48,96,0.5,1.23076923076923
12,"Phantom Lancer",33,"Enigma",25,39,64,0.390625,0.82051282051282
12,"Phantom Lancer",34,"Tinker",28,44,72,0.388888888888889,0.923076923076923
12,"Phantom Lancer",35,"Sniper",33,39,72,0.458333333333333,0.923076923076923
12,"Phantom Lancer",36,"Necrophos",95,72,167,0.568862275449102,2.14102564102564
12,"Phantom Lancer",37,"Warlock",29,31,60,0.483333333333333,0.769230769230769
12,"Phantom Lancer",38,"Beastmaster",18,16,34,0.529411764705882,0.435897435897436
12,"Phantom Lancer",39,"Queen of Pain",107,183,290,0.368965517241379,3.71794871794872
12,"Phantom Lancer",40,"Venomancer",50,39,89,0.561797752808989,1.14102564102564
12,"Phantom Lancer",41,"Faceless Void",13,26,39,0.333333333333333,0.5
12,"Phantom Lancer",42,"Wraith King",46,42,88,0.522727272727273,1.12820512820513
12,"Phantom Lancer",43,"Death Prophet",26,20,46,0.565217391304348,0.58974358974359
12,"Phantom Lancer",44,"Phantom Assassin",33,49,82,0.402439024390244,1.05128205128205
12,"Phantom Lancer",45,"Pugna",20,22,42,0.476190476190476,0.538461538461538
12,"Phantom Lancer",46,"Templar Assassin",77,96,173,0.445086705202312,2.21794871794872
12,"Phantom Lancer",47,"Viper",51,52,103,0.495145631067961,1.32051282051282
12,"Phantom Lancer",48,"Luna",14,18,32,0.4375,0.41025641025641
12,"Phantom Lancer",49,"Dragon Knight",18,29,47,0.382978723404255,0.602564102564103
12,"Phantom Lancer",50,"Dazzle",153,142,295,0.51864406779661,3.78205128205128
12,"Phantom Lancer",51,"Clockwerk",55,74,129,0.426356589147287,1.65384615384615
12,"Phantom Lancer",52,"Leshrac",14,25,39,0.358974358974359,0.5
12,"Phantom Lancer",53,"Nature's Prophet",36,50,86,0.418604651162791,1.1025641025641
12,"Phantom Lancer",54,"Lifestealer",17,30,47,0.361702127659574,0.602564102564103
12,"Phantom Lancer",55,"Dark Seer",49,56,105,0.466666666666667,1.34615384615385
12,"Phantom Lancer",56,"Clinkz",18,26,44,0.409090909090909,0.564102564102564
12,"Phantom Lancer",57,"Omniknight",67,55,122,0.549180327868853,1.56410256410256
12,"Phantom Lancer",58,"Enchantress",6,15,21,0.285714285714286,0.269230769230769
12,"Phantom Lancer",59,"Huskar",32,44,76,0.421052631578947,0.974358974358974
12,"Phantom Lancer",60,"Night Stalker",25,54,79,0.316455696202532,1.01282051282051
12,"Phantom Lancer",61,"Broodmother",7,20,27,0.259259259259259,0.346153846153846
12,"Phantom Lancer",62,"Bounty Hunter",79,106,185,0.427027027027027,2.37179487179487
12,"Phantom Lancer",63,"Weaver",20,35,55,0.363636363636364,0.705128205128205
12,"Phantom Lancer",64,"Jakiro",40,49,89,0.449438202247191,1.14102564102564
12,"Phantom Lancer",65,"Batrider",12,22,34,0.352941176470588,0.435897435897436
12,"Phantom Lancer",66,"Chen",6,8,14,0.428571428571429,0.179487179487179
12,"Phantom Lancer",67,"Spectre",12,14,26,0.461538461538462,0.333333333333333
12,"Phantom Lancer",68,"Ancient Apparition",93,113,206,0.451456310679612,2.64102564102564
12,"Phantom Lancer",69,"Doom",120,112,232,0.517241379310345,2.97435897435897
12,"Phantom Lancer",70,"Ursa",36,36,72,0.5,0.923076923076923
12,"Phantom Lancer",71,"Spirit Breaker",96,108,204,0.470588235294118,2.61538461538462
12,"Phantom Lancer",72,"Gyrocopter",21,30,51,0.411764705882353,0.653846153846154
12,"Phantom Lancer",73,"Alchemist",100,99,199,0.50251256281407,2.55128205128205
12,"Phantom Lancer",74,"Invoker",165,228,393,0.419847328244275,5.03846153846154
12,"Phantom Lancer",75,"Silencer",89,111,200,0.445,2.56410256410256
12,"Phantom Lancer",76,"Outworld Devourer",24,27,51,0.470588235294118,0.653846153846154
12,"Phantom Lancer",77,"Lycan",9,10,19,0.473684210526316,0.243589743589744
12,"Phantom Lancer",78,"Brewmaster",12,15,27,0.444444444444444,0.346153846153846
12,"Phantom Lancer",79,"Shadow Demon",12,33,45,0.266666666666667,0.576923076923077
12,"Phantom Lancer",80,"Lone Druid",14,11,25,0.56,0.320512820512821
12,"Phantom Lancer",81,"Chaos Knight",12,21,33,0.363636363636364,0.423076923076923
12,"Phantom Lancer",82,"Meepo",10,19,29,0.344827586206897,0.371794871794872
12,"Phantom Lancer",83,"Treant Protector",20,25,45,0.444444444444444,0.576923076923077
12,"Phantom Lancer",84,"Ogre Magi",75,62,137,0.547445255474453,1.75641025641026
12,"Phantom Lancer",85,"Undying",76,79,155,0.490322580645161,1.98717948717949
12,"Phantom Lancer",86,"Rubick",83,147,230,0.360869565217391,2.94871794871795
12,"Phantom Lancer",87,"Disruptor",60,88,148,0.405405405405405,1.8974358974359
12,"Phantom Lancer",88,"Nyx Assassin",33,41,74,0.445945945945946,0.948717948717949
12,"Phantom Lancer",89,"Naga Siren",0,18,18,0,0.230769230769231
12,"Phantom Lancer",90,"Keeper of the Light",61,62,123,0.495934959349593,1.57692307692308
12,"Phantom Lancer",91,"Io",11,21,32,0.34375,0.41025641025641
12,"Phantom Lancer",92,"Visage",9,13,22,0.409090909090909,0.282051282051282
12,"Phantom Lancer",93,"Slark",48,49,97,0.494845360824742,1.24358974358974
12,"Phantom Lancer",94,"Medusa",13,13,26,0.5,0.333333333333333
12,"Phantom Lancer",95,"Troll Warlord",9,22,31,0.290322580645161,0.397435897435897
12,"Phantom Lancer",96,"Centaur Warrunner",20,27,47,0.425531914893617,0.602564102564103
12,"Phantom Lancer",97,"Magnus",25,54,79,0.316455696202532,1.01282051282051
12,"Phantom Lancer",98,"Timbersaw",27,45,72,0.375,0.923076923076923
12,"Phantom Lancer",99,"Bristleback",42,44,86,0.488372093023256,1.1025641025641
12,"Phantom Lancer",100,"Tusk",128,144,272,0.470588235294118,3.48717948717949
12,"Phantom Lancer",101,"Skywrath Mage",26,40,66,0.393939393939394,0.846153846153846
12,"Phantom Lancer",102,"Abaddon",45,47,92,0.489130434782609,1.17948717948718
12,"Phantom Lancer",103,"Elder Titan",14,15,29,0.482758620689655,0.371794871794872
12,"Phantom Lancer",104,"Legion Commander",76,112,188,0.404255319148936,2.41025641025641
12,"Phantom Lancer",105,"Techies",13,14,27,0.481481481481481,0.346153846153846
12,"Phantom Lancer",106,"Ember Spirit",52,90,142,0.366197183098592,1.82051282051282
12,"Phantom Lancer",107,"Earth Spirit",37,34,71,0.52112676056338,0.91025641025641
12,"Phantom Lancer",109,"Terrorblade",9,12,21,0.428571428571429,0.269230769230769
12,"Phantom Lancer",110,"Phoenix",41,59,100,0.41,1.28205128205128
12,"Phantom Lancer",111,"Oracle",11,19,30,0.366666666666667,0.384615384615385
12,"Phantom Lancer",112,"Winter Wyvern",115,120,235,0.48936170212766,3.01282051282051
13,"Puck",14,"Pudge",50,64,114,0.43859649122807,1.46153846153846
13,"Puck",15,"Razor",9,8,17,0.529411764705882,0.217948717948718
13,"Puck",16,"Sand King",17,28,45,0.377777777777778,0.576923076923077
13,"Puck",17,"Storm Spirit",10,9,19,0.526315789473684,0.243589743589744
13,"Puck",18,"Sven",27,28,55,0.490909090909091,0.705128205128205
13,"Puck",19,"Tiny",23,42,65,0.353846153846154,0.833333333333333
13,"Puck",20,"Vengeful Spirit",26,45,71,0.366197183098592,0.91025641025641
13,"Puck",21,"Windranger",87,119,206,0.422330097087379,2.64102564102564
13,"Puck",22,"Zeus",13,14,27,0.481481481481481,0.346153846153846
13,"Puck",23,"Kunkka",17,24,41,0.414634146341463,0.525641025641026
13,"Puck",25,"Lina",26,48,74,0.351351351351351,0.948717948717949
13,"Puck",26,"Lion",34,58,92,0.369565217391304,1.17948717948718
13,"Puck",27,"Shadow Shaman",28,17,45,0.622222222222222,0.576923076923077
13,"Puck",28,"Slardar",57,66,123,0.463414634146341,1.57692307692308
13,"Puck",29,"Tidehunter",14,16,30,0.466666666666667,0.384615384615385
13,"Puck",30,"Witch Doctor",42,64,106,0.39622641509434,1.35897435897436
13,"Puck",31,"Lich",22,28,50,0.44,0.641025641025641
13,"Puck",32,"Riki",27,27,54,0.5,0.692307692307692
13,"Puck",33,"Enigma",18,29,47,0.382978723404255,0.602564102564103
13,"Puck",34,"Tinker",6,15,21,0.285714285714286,0.269230769230769
13,"Puck",35,"Sniper",21,26,47,0.446808510638298,0.602564102564103
13,"Puck",36,"Necrophos",28,30,58,0.482758620689655,0.743589743589744
13,"Puck",37,"Warlock",5,11,16,0.3125,0.205128205128205
13,"Puck",38,"Beastmaster",7,11,18,0.388888888888889,0.230769230769231
13,"Puck",39,"Queen of Pain",19,29,48,0.395833333333333,0.615384615384615
13,"Puck",40,"Venomancer",19,24,43,0.441860465116279,0.551282051282051
13,"Puck",41,"Faceless Void",18,31,49,0.36734693877551,0.628205128205128
13,"Puck",42,"Wraith King",57,54,111,0.513513513513513,1.42307692307692
13,"Puck",43,"Death Prophet",6,6,12,0.5,0.153846153846154
13,"Puck",44,"Phantom Assassin",46,58,104,0.442307692307692,1.33333333333333
13,"Puck",45,"Pugna",5,14,19,0.263157894736842,0.243589743589744
13,"Puck",46,"Templar Assassin",19,30,49,0.387755102040816,0.628205128205128
13,"Puck",47,"Viper",13,18,31,0.419354838709677,0.397435897435897
13,"Puck",48,"Luna",13,25,38,0.342105263157895,0.487179487179487
13,"Puck",49,"Dragon Knight",8,14,22,0.363636363636364,0.282051282051282
13,"Puck",50,"Dazzle",37,65,102,0.362745098039216,1.30769230769231
13,"Puck",51,"Clockwerk",21,17,38,0.552631578947368,0.487179487179487
13,"Puck",52,"Leshrac",4,12,16,0.25,0.205128205128205
13,"Puck",53,"Nature's Prophet",20,24,44,0.454545454545455,0.564102564102564
13,"Puck",54,"Lifestealer",18,19,37,0.486486486486487,0.474358974358974
13,"Puck",55,"Dark Seer",14,32,46,0.304347826086957,0.58974358974359
13,"Puck",56,"Clinkz",11,25,36,0.305555555555556,0.461538461538462
13,"Puck",57,"Omniknight",36,36,72,0.5,0.923076923076923
13,"Puck",58,"Enchantress",4,9,13,0.307692307692308,0.166666666666667
13,"Puck",59,"Huskar",11,29,40,0.275,0.512820512820513
13,"Puck",60,"Night Stalker",9,17,26,0.346153846153846,0.333333333333333
13,"Puck",61,"Broodmother",3,2,5,0.6,0.0641025641025641
13,"Puck",62,"Bounty Hunter",36,58,94,0.382978723404255,1.20512820512821
13,"Puck",63,"Weaver",10,22,32,0.3125,0.41025641025641
13,"Puck",64,"Jakiro",17,18,35,0.485714285714286,0.448717948717949
13,"Puck",65,"Batrider",4,8,12,0.333333333333333,0.153846153846154
13,"Puck",66,"Chen",3,3,6,0.5,0.0769230769230769
13,"Puck",67,"Spectre",52,50,102,0.509803921568627,1.30769230769231
13,"Puck",68,"Ancient Apparition",24,57,81,0.296296296296296,1.03846153846154
13,"Puck",69,"Doom",38,55,93,0.408602150537634,1.19230769230769
13,"Puck",70,"Ursa",39,36,75,0.52,0.961538461538462
13,"Puck",71,"Spirit Breaker",47,50,97,0.484536082474227,1.24358974358974
13,"Puck",72,"Gyrocopter",44,54,98,0.448979591836735,1.25641025641026
13,"Puck",73,"Alchemist",48,46,94,0.51063829787234,1.20512820512821
13,"Puck",74,"Invoker",32,42,74,0.432432432432432,0.948717948717949
13,"Puck",75,"Silencer",27,42,69,0.391304347826087,0.884615384615385
13,"Puck",76,"Outworld Devourer",6,9,15,0.4,0.192307692307692
13,"Puck",77,"Lycan",9,6,15,0.6,0.192307692307692
13,"Puck",78,"Brewmaster",4,7,11,0.363636363636364,0.141025641025641
13,"Puck",79,"Shadow Demon",3,6,9,0.333333333333333,0.115384615384615
13,"Puck",80,"Lone Druid",10,6,16,0.625,0.205128205128205
13,"Puck",81,"Chaos Knight",17,24,41,0.414634146341463,0.525641025641026
13,"Puck",82,"Meepo",3,21,24,0.125,0.307692307692308
13,"Puck",83,"Treant Protector",11,14,25,0.44,0.320512820512821
13,"Puck",84,"Ogre Magi",27,37,64,0.421875,0.82051282051282
13,"Puck",85,"Undying",36,48,84,0.428571428571429,1.07692307692308
13,"Puck",86,"Rubick",46,67,113,0.407079646017699,1.44871794871795
13,"Puck",87,"Disruptor",32,27,59,0.542372881355932,0.756410256410256
13,"Puck",88,"Nyx Assassin",13,21,34,0.382352941176471,0.435897435897436
13,"Puck",89,"Naga Siren",7,5,12,0.583333333333333,0.153846153846154
13,"Puck",90,"Keeper of the Light",5,20,25,0.2,0.320512820512821
13,"Puck",91,"Io",7,7,14,0.5,0.179487179487179
13,"Puck",92,"Visage",6,6,12,0.5,0.153846153846154
13,"Puck",93,"Slark",46,70,116,0.396551724137931,1.48717948717949
13,"Puck",94,"Medusa",20,15,35,0.571428571428571,0.448717948717949
13,"Puck",95,"Troll Warlord",10,10,20,0.5,0.256410256410256
13,"Puck",96,"Centaur Warrunner",6,14,20,0.3,0.256410256410256
13,"Puck",97,"Magnus",18,23,41,0.439024390243902,0.525641025641026
13,"Puck",98,"Timbersaw",13,20,33,0.393939393939394,0.423076923076923
13,"Puck",99,"Bristleback",24,31,55,0.436363636363636,0.705128205128205
13,"Puck",100,"Tusk",44,72,116,0.379310344827586,1.48717948717949
13,"Puck",101,"Skywrath Mage",8,30,38,0.210526315789474,0.487179487179487
13,"Puck",102,"Abaddon",21,14,35,0.6,0.448717948717949
13,"Puck",103,"Elder Titan",2,6,8,0.25,0.102564102564103
13,"Puck",104,"Legion Commander",54,68,122,0.442622950819672,1.56410256410256
13,"Puck",105,"Techies",6,6,12,0.5,0.153846153846154
13,"Puck",106,"Ember Spirit",29,41,70,0.414285714285714,0.897435897435897
13,"Puck",107,"Earth Spirit",17,17,34,0.5,0.435897435897436
13,"Puck",109,"Terrorblade",16,8,24,0.666666666666667,0.307692307692308
13,"Puck",110,"Phoenix",15,20,35,0.428571428571429,0.448717948717949
13,"Puck",111,"Oracle",10,10,20,0.5,0.256410256410256
13,"Puck",112,"Winter Wyvern",54,47,101,0.534653465346535,1.29487179487179
14,"Pudge",15,"Razor",43,61,104,0.413461538461538,1.33333333333333
14,"Pudge",16,"Sand King",80,94,174,0.459770114942529,2.23076923076923
14,"Pudge",17,"Storm Spirit",59,75,134,0.440298507462687,1.71794871794872
14,"Pudge",18,"Sven",110,112,222,0.495495495495495,2.84615384615385
14,"Pudge",19,"Tiny",141,189,330,0.427272727272727,4.23076923076923
14,"Pudge",20,"Vengeful Spirit",119,112,231,0.515151515151515,2.96153846153846
14,"Pudge",21,"Windranger",671,724,1395,0.481003584229391,17.8846153846154
14,"Pudge",22,"Zeus",134,124,258,0.51937984496124,3.30769230769231
14,"Pudge",23,"Kunkka",79,116,195,0.405128205128205,2.5
14,"Pudge",25,"Lina",208,300,508,0.409448818897638,6.51282051282051
14,"Pudge",26,"Lion",213,268,481,0.442827442827443,6.16666666666667
14,"Pudge",27,"Shadow Shaman",125,120,245,0.510204081632653,3.14102564102564
14,"Pudge",28,"Slardar",296,279,575,0.514782608695652,7.37179487179487
14,"Pudge",29,"Tidehunter",66,58,124,0.532258064516129,1.58974358974359
14,"Pudge",30,"Witch Doctor",225,236,461,0.488069414316703,5.91025641025641
14,"Pudge",31,"Lich",126,90,216,0.583333333333333,2.76923076923077
14,"Pudge",32,"Riki",184,154,338,0.544378698224852,4.33333333333333
14,"Pudge",33,"Enigma",69,74,143,0.482517482517482,1.83333333333333
14,"Pudge",34,"Tinker",67,95,162,0.41358024691358,2.07692307692308
14,"Pudge",35,"Sniper",133,164,297,0.447811447811448,3.80769230769231
14,"Pudge",36,"Necrophos",248,194,442,0.561085972850679,5.66666666666667
14,"Pudge",37,"Warlock",66,48,114,0.578947368421053,1.46153846153846
14,"Pudge",38,"Beastmaster",34,38,72,0.472222222222222,0.923076923076923
14,"Pudge",39,"Queen of Pain",275,304,579,0.474956822107081,7.42307692307692
14,"Pudge",40,"Venomancer",103,89,192,0.536458333333333,2.46153846153846
14,"Pudge",41,"Faceless Void",121,158,279,0.433691756272401,3.57692307692308
14,"Pudge",42,"Wraith King",275,219,494,0.55668016194332,6.33333333333333
14,"Pudge",43,"Death Prophet",44,54,98,0.448979591836735,1.25641025641026
14,"Pudge",44,"Phantom Assassin",282,350,632,0.44620253164557,8.1025641025641
14,"Pudge",45,"Pugna",59,65,124,0.475806451612903,1.58974358974359
14,"Pudge",46,"Templar Assassin",175,181,356,0.491573033707865,4.56410256410256
14,"Pudge",47,"Viper",112,116,228,0.491228070175439,2.92307692307692
14,"Pudge",48,"Luna",93,73,166,0.560240963855422,2.12820512820513
14,"Pudge",49,"Dragon Knight",58,72,130,0.446153846153846,1.66666666666667
14,"Pudge",50,"Dazzle",228,212,440,0.518181818181818,5.64102564102564
14,"Pudge",51,"Clockwerk",117,115,232,0.504310344827586,2.97435897435897
14,"Pudge",52,"Leshrac",35,37,72,0.486111111111111,0.923076923076923
14,"Pudge",53,"Nature's Prophet",107,147,254,0.421259842519685,3.25641025641026
14,"Pudge",54,"Lifestealer",107,124,231,0.463203463203463,2.96153846153846
14,"Pudge",55,"Dark Seer",120,120,240,0.5,3.07692307692308
14,"Pudge",56,"Clinkz",92,103,195,0.471794871794872,2.5
14,"Pudge",57,"Omniknight",225,145,370,0.608108108108108,4.74358974358974
14,"Pudge",58,"Enchantress",27,39,66,0.409090909090909,0.846153846153846
14,"Pudge",59,"Huskar",128,149,277,0.462093862815884,3.55128205128205
14,"Pudge",60,"Night Stalker",92,70,162,0.567901234567901,2.07692307692308
14,"Pudge",61,"Broodmother",38,52,90,0.422222222222222,1.15384615384615
14,"Pudge",62,"Bounty Hunter",167,202,369,0.452574525745257,4.73076923076923
14,"Pudge",63,"Weaver",95,89,184,0.516304347826087,2.35897435897436
14,"Pudge",64,"Jakiro",82,86,168,0.488095238095238,2.15384615384615
14,"Pudge",65,"Batrider",34,29,63,0.53968253968254,0.807692307692308
14,"Pudge",66,"Chen",19,27,46,0.41304347826087,0.58974358974359
14,"Pudge",67,"Spectre",271,201,472,0.574152542372881,6.05128205128205
14,"Pudge",68,"Ancient Apparition",184,195,379,0.485488126649077,4.85897435897436
14,"Pudge",69,"Doom",214,205,419,0.510739856801909,5.37179487179487
14,"Pudge",70,"Ursa",173,142,315,0.549206349206349,4.03846153846154
14,"Pudge",71,"Spirit Breaker",211,181,392,0.538265306122449,5.02564102564103
14,"Pudge",72,"Gyrocopter",230,246,476,0.483193277310924,6.1025641025641
14,"Pudge",73,"Alchemist",363,328,691,0.525325615050651,8.85897435897436
14,"Pudge",74,"Invoker",348,379,727,0.478679504814305,9.32051282051282
14,"Pudge",75,"Silencer",258,216,474,0.544303797468354,6.07692307692308
14,"Pudge",76,"Outworld Devourer",45,57,102,0.441176470588235,1.30769230769231
14,"Pudge",77,"Lycan",31,24,55,0.563636363636364,0.705128205128205
14,"Pudge",78,"Brewmaster",25,28,53,0.471698113207547,0.67948717948718
14,"Pudge",79,"Shadow Demon",32,48,80,0.4,1.02564102564103
14,"Pudge",80,"Lone Druid",23,41,64,0.359375,0.82051282051282
14,"Pudge",81,"Chaos Knight",82,91,173,0.473988439306358,2.21794871794872
14,"Pudge",82,"Meepo",47,57,104,0.451923076923077,1.33333333333333
14,"Pudge",83,"Treant Protector",55,60,115,0.478260869565217,1.47435897435897
14,"Pudge",84,"Ogre Magi",121,114,235,0.514893617021277,3.01282051282051
14,"Pudge",85,"Undying",138,133,271,0.509225092250922,3.47435897435897
14,"Pudge",86,"Rubick",225,242,467,0.481798715203426,5.98717948717949
14,"Pudge",87,"Disruptor",168,127,295,0.569491525423729,3.78205128205128
14,"Pudge",88,"Nyx Assassin",77,87,164,0.469512195121951,2.1025641025641
14,"Pudge",89,"Naga Siren",30,37,67,0.447761194029851,0.858974358974359
14,"Pudge",90,"Keeper of the Light",81,76,157,0.515923566878981,2.01282051282051
14,"Pudge",91,"Io",35,53,88,0.397727272727273,1.12820512820513
14,"Pudge",92,"Visage",19,36,55,0.345454545454545,0.705128205128205
14,"Pudge",93,"Slark",284,315,599,0.474123539232053,7.67948717948718
14,"Pudge",94,"Medusa",89,88,177,0.502824858757062,2.26923076923077
14,"Pudge",95,"Troll Warlord",66,72,138,0.478260869565217,1.76923076923077
14,"Pudge",96,"Centaur Warrunner",62,58,120,0.516666666666667,1.53846153846154
14,"Pudge",97,"Magnus",82,97,179,0.458100558659218,2.29487179487179
14,"Pudge",98,"Timbersaw",77,86,163,0.47239263803681,2.08974358974359
14,"Pudge",99,"Bristleback",124,128,252,0.492063492063492,3.23076923076923
14,"Pudge",100,"Tusk",258,328,586,0.440273037542662,7.51282051282051
14,"Pudge",101,"Skywrath Mage",65,100,165,0.393939393939394,2.11538461538462
14,"Pudge",102,"Abaddon",118,77,195,0.605128205128205,2.5
14,"Pudge",103,"Elder Titan",26,28,54,0.481481481481481,0.692307692307692
14,"Pudge",104,"Legion Commander",331,381,712,0.464887640449438,9.12820512820513
14,"Pudge",105,"Techies",52,71,123,0.422764227642276,1.57692307692308
14,"Pudge",106,"Ember Spirit",171,243,414,0.41304347826087,5.30769230769231
14,"Pudge",107,"Earth Spirit",78,79,157,0.496815286624204,2.01282051282051
14,"Pudge",109,"Terrorblade",70,63,133,0.526315789473684,1.70512820512821
14,"Pudge",110,"Phoenix",84,82,166,0.506024096385542,2.12820512820513
14,"Pudge",111,"Oracle",34,39,73,0.465753424657534,0.935897435897436
14,"Pudge",112,"Winter Wyvern",226,188,414,0.545893719806763,5.30769230769231
15,"Razor",16,"Sand King",19,38,57,0.333333333333333,0.730769230769231
15,"Razor",17,"Storm Spirit",11,15,26,0.423076923076923,0.333333333333333
15,"Razor",18,"Sven",19,16,35,0.542857142857143,0.448717948717949
15,"Razor",19,"Tiny",26,30,56,0.464285714285714,0.717948717948718
15,"Razor",20,"Vengeful Spirit",29,26,55,0.527272727272727,0.705128205128205
15,"Razor",21,"Windranger",111,127,238,0.466386554621849,3.05128205128205
15,"Razor",22,"Zeus",32,33,65,0.492307692307692,0.833333333333333
15,"Razor",23,"Kunkka",10,20,30,0.333333333333333,0.384615384615385
15,"Razor",25,"Lina",33,56,89,0.370786516853933,1.14102564102564
15,"Razor",26,"Lion",59,68,127,0.464566929133858,1.62820512820513
15,"Razor",27,"Shadow Shaman",35,34,69,0.507246376811594,0.884615384615385
15,"Razor",28,"Slardar",75,74,149,0.503355704697987,1.91025641025641
15,"Razor",29,"Tidehunter",16,20,36,0.444444444444444,0.461538461538462
15,"Razor",30,"Witch Doctor",58,66,124,0.467741935483871,1.58974358974359
15,"Razor",31,"Lich",31,31,62,0.5,0.794871794871795
15,"Razor",32,"Riki",29,27,56,0.517857142857143,0.717948717948718
15,"Razor",33,"Enigma",24,27,51,0.470588235294118,0.653846153846154
15,"Razor",34,"Tinker",10,12,22,0.454545454545455,0.282051282051282
15,"Razor",35,"Sniper",18,40,58,0.310344827586207,0.743589743589744
15,"Razor",36,"Necrophos",47,35,82,0.573170731707317,1.05128205128205
15,"Razor",37,"Warlock",20,15,35,0.571428571428571,0.448717948717949
15,"Razor",38,"Beastmaster",11,12,23,0.478260869565217,0.294871794871795
15,"Razor",39,"Queen of Pain",58,55,113,0.513274336283186,1.44871794871795
15,"Razor",40,"Venomancer",23,27,50,0.46,0.641025641025641
15,"Razor",41,"Faceless Void",16,28,44,0.363636363636364,0.564102564102564
15,"Razor",42,"Wraith King",60,45,105,0.571428571428571,1.34615384615385
15,"Razor",43,"Death Prophet",5,17,22,0.227272727272727,0.282051282051282
15,"Razor",44,"Phantom Assassin",39,49,88,0.443181818181818,1.12820512820513
15,"Razor",45,"Pugna",10,14,24,0.416666666666667,0.307692307692308
15,"Razor",46,"Templar Assassin",19,44,63,0.301587301587302,0.807692307692308
15,"Razor",47,"Viper",18,24,42,0.428571428571429,0.538461538461538
15,"Razor",48,"Luna",14,18,32,0.4375,0.41025641025641
15,"Razor",49,"Dragon Knight",6,11,17,0.352941176470588,0.217948717948718
15,"Razor",50,"Dazzle",71,61,132,0.537878787878788,1.69230769230769
15,"Razor",51,"Clockwerk",31,36,67,0.462686567164179,0.858974358974359
15,"Razor",52,"Leshrac",10,6,16,0.625,0.205128205128205
15,"Razor",53,"Nature's Prophet",18,47,65,0.276923076923077,0.833333333333333
15,"Razor",54,"Lifestealer",13,15,28,0.464285714285714,0.358974358974359
15,"Razor",55,"Dark Seer",27,44,71,0.380281690140845,0.91025641025641
15,"Razor",56,"Clinkz",15,18,33,0.454545454545455,0.423076923076923
15,"Razor",57,"Omniknight",53,41,94,0.563829787234043,1.20512820512821
15,"Razor",58,"Enchantress",1,15,16,0.0625,0.205128205128205
15,"Razor",59,"Huskar",27,18,45,0.6,0.576923076923077
15,"Razor",60,"Night Stalker",22,29,51,0.431372549019608,0.653846153846154
15,"Razor",61,"Broodmother",6,10,16,0.375,0.205128205128205
15,"Razor",62,"Bounty Hunter",45,60,105,0.428571428571429,1.34615384615385
15,"Razor",63,"Weaver",10,20,30,0.333333333333333,0.384615384615385
15,"Razor",64,"Jakiro",19,12,31,0.612903225806452,0.397435897435897
15,"Razor",65,"Batrider",4,9,13,0.307692307692308,0.166666666666667
15,"Razor",66,"Chen",3,4,7,0.428571428571429,0.0897435897435897
15,"Razor",67,"Spectre",37,32,69,0.536231884057971,0.884615384615385
15,"Razor",68,"Ancient Apparition",50,58,108,0.462962962962963,1.38461538461538
15,"Razor",69,"Doom",44,41,85,0.517647058823529,1.08974358974359
15,"Razor",70,"Ursa",44,36,80,0.55,1.02564102564103
15,"Razor",71,"Spirit Breaker",50,48,98,0.510204081632653,1.25641025641026
15,"Razor",72,"Gyrocopter",33,45,78,0.423076923076923,1
15,"Razor",73,"Alchemist",59,59,118,0.5,1.51282051282051
15,"Razor",74,"Invoker",50,67,117,0.427350427350427,1.5
15,"Razor",75,"Silencer",37,42,79,0.468354430379747,1.01282051282051
15,"Razor",76,"Outworld Devourer",8,12,20,0.4,0.256410256410256
15,"Razor",77,"Lycan",11,1,12,0.916666666666667,0.153846153846154
15,"Razor",78,"Brewmaster",4,6,10,0.4,0.128205128205128
15,"Razor",79,"Shadow Demon",12,10,22,0.545454545454545,0.282051282051282
15,"Razor",80,"Lone Druid",3,7,10,0.3,0.128205128205128
15,"Razor",81,"Chaos Knight",20,23,43,0.465116279069767,0.551282051282051
15,"Razor",82,"Meepo",2,10,12,0.166666666666667,0.153846153846154
15,"Razor",83,"Treant Protector",16,23,39,0.41025641025641,0.5
15,"Razor",84,"Ogre Magi",41,44,85,0.482352941176471,1.08974358974359
15,"Razor",85,"Undying",59,46,105,0.561904761904762,1.34615384615385
15,"Razor",86,"Rubick",60,82,142,0.422535211267606,1.82051282051282
15,"Razor",87,"Disruptor",48,43,91,0.527472527472527,1.16666666666667
15,"Razor",88,"Nyx Assassin",22,19,41,0.536585365853659,0.525641025641026
15,"Razor",89,"Naga Siren",6,10,16,0.375,0.205128205128205
15,"Razor",90,"Keeper of the Light",18,13,31,0.580645161290323,0.397435897435897
15,"Razor",91,"Io",14,14,28,0.5,0.358974358974359
15,"Razor",92,"Visage",7,20,27,0.259259259259259,0.346153846153846
15,"Razor",93,"Slark",35,53,88,0.397727272727273,1.12820512820513
15,"Razor",94,"Medusa",11,20,31,0.354838709677419,0.397435897435897
15,"Razor",95,"Troll Warlord",7,11,18,0.388888888888889,0.230769230769231
15,"Razor",96,"Centaur Warrunner",15,16,31,0.483870967741935,0.397435897435897
15,"Razor",97,"Magnus",12,20,32,0.375,0.41025641025641
15,"Razor",98,"Timbersaw",19,27,46,0.41304347826087,0.58974358974359
15,"Razor",99,"Bristleback",21,36,57,0.368421052631579,0.730769230769231
15,"Razor",100,"Tusk",78,87,165,0.472727272727273,2.11538461538462
15,"Razor",101,"Skywrath Mage",8,32,40,0.2,0.512820512820513
15,"Razor",102,"Abaddon",28,33,61,0.459016393442623,0.782051282051282
15,"Razor",103,"Elder Titan",11,2,13,0.846153846153846,0.166666666666667
15,"Razor",104,"Legion Commander",59,62,121,0.487603305785124,1.55128205128205
15,"Razor",105,"Techies",3,11,14,0.214285714285714,0.179487179487179
15,"Razor",106,"Ember Spirit",39,36,75,0.52,0.961538461538462
15,"Razor",107,"Earth Spirit",25,18,43,0.581395348837209,0.551282051282051
15,"Razor",109,"Terrorblade",7,10,17,0.411764705882353,0.217948717948718
15,"Razor",110,"Phoenix",15,15,30,0.5,0.384615384615385
15,"Razor",111,"Oracle",8,11,19,0.421052631578947,0.243589743589744
15,"Razor",112,"Winter Wyvern",54,55,109,0.495412844036697,1.3974358974359
16,"Sand King",17,"Storm Spirit",24,43,67,0.358208955223881,0.858974358974359
16,"Sand King",18,"Sven",28,41,69,0.405797101449275,0.884615384615385
16,"Sand King",19,"Tiny",61,58,119,0.512605042016807,1.52564102564103
16,"Sand King",20,"Vengeful Spirit",31,39,70,0.442857142857143,0.897435897435897
16,"Sand King",21,"Windranger",235,293,528,0.445075757575758,6.76923076923077
16,"Sand King",22,"Zeus",52,50,102,0.509803921568627,1.30769230769231
16,"Sand King",23,"Kunkka",25,31,56,0.446428571428571,0.717948717948718
16,"Sand King",25,"Lina",80,124,204,0.392156862745098,2.61538461538462
16,"Sand King",26,"Lion",45,78,123,0.365853658536585,1.57692307692308
16,"Sand King",27,"Shadow Shaman",34,22,56,0.607142857142857,0.717948717948718
16,"Sand King",28,"Slardar",109,104,213,0.511737089201878,2.73076923076923
16,"Sand King",29,"Tidehunter",22,24,46,0.478260869565217,0.58974358974359
16,"Sand King",30,"Witch Doctor",55,80,135,0.407407407407407,1.73076923076923
16,"Sand King",31,"Lich",37,44,81,0.45679012345679,1.03846153846154
16,"Sand King",32,"Riki",47,37,84,0.55952380952381,1.07692307692308
16,"Sand King",33,"Enigma",17,17,34,0.5,0.435897435897436
16,"Sand King",34,"Tinker",24,34,58,0.413793103448276,0.743589743589744
16,"Sand King",35,"Sniper",40,57,97,0.412371134020619,1.24358974358974
16,"Sand King",36,"Necrophos",72,56,128,0.5625,1.64102564102564
16,"Sand King",37,"Warlock",23,22,45,0.511111111111111,0.576923076923077
16,"Sand King",38,"Beastmaster",13,14,27,0.481481481481481,0.346153846153846
16,"Sand King",39,"Queen of Pain",102,150,252,0.404761904761905,3.23076923076923
16,"Sand King",40,"Venomancer",30,32,62,0.483870967741935,0.794871794871795
16,"Sand King",41,"Faceless Void",36,37,73,0.493150684931507,0.935897435897436
16,"Sand King",42,"Wraith King",98,69,167,0.586826347305389,2.14102564102564
16,"Sand King",43,"Death Prophet",24,23,47,0.51063829787234,0.602564102564103
16,"Sand King",44,"Phantom Assassin",75,132,207,0.36231884057971,2.65384615384615
16,"Sand King",45,"Pugna",20,19,39,0.512820512820513,0.5
16,"Sand King",46,"Templar Assassin",81,91,172,0.47093023255814,2.20512820512821
16,"Sand King",47,"Viper",43,38,81,0.530864197530864,1.03846153846154
16,"Sand King",48,"Luna",26,34,60,0.433333333333333,0.769230769230769
16,"Sand King",49,"Dragon Knight",20,24,44,0.454545454545455,0.564102564102564
16,"Sand King",50,"Dazzle",76,70,146,0.520547945205479,1.87179487179487
16,"Sand King",51,"Clockwerk",45,59,104,0.432692307692308,1.33333333333333
16,"Sand King",52,"Leshrac",17,22,39,0.435897435897436,0.5
16,"Sand King",53,"Nature's Prophet",15,32,47,0.319148936170213,0.602564102564103
16,"Sand King",54,"Lifestealer",11,24,35,0.314285714285714,0.448717948717949
16,"Sand King",55,"Dark Seer",51,61,112,0.455357142857143,1.43589743589744
16,"Sand King",56,"Clinkz",32,33,65,0.492307692307692,0.833333333333333
16,"Sand King",57,"Omniknight",58,31,89,0.651685393258427,1.14102564102564
16,"Sand King",58,"Enchantress",9,13,22,0.409090909090909,0.282051282051282
16,"Sand King",59,"Huskar",44,41,85,0.517647058823529,1.08974358974359
16,"Sand King",60,"Night Stalker",33,30,63,0.523809523809524,0.807692307692308
16,"Sand King",61,"Broodmother",11,22,33,0.333333333333333,0.423076923076923
16,"Sand King",62,"Bounty Hunter",44,45,89,0.49438202247191,1.14102564102564
16,"Sand King",63,"Weaver",32,29,61,0.524590163934426,0.782051282051282
16,"Sand King",64,"Jakiro",24,39,63,0.380952380952381,0.807692307692308
16,"Sand King",65,"Batrider",9,13,22,0.409090909090909,0.282051282051282
16,"Sand King",66,"Chen",0,3,3,0,0.0384615384615385
16,"Sand King",67,"Spectre",95,73,168,0.56547619047619,2.15384615384615
16,"Sand King",68,"Ancient Apparition",70,67,137,0.510948905109489,1.75641025641026
16,"Sand King",69,"Doom",56,72,128,0.4375,1.64102564102564
16,"Sand King",70,"Ursa",43,31,74,0.581081081081081,0.948717948717949
16,"Sand King",71,"Spirit Breaker",57,76,133,0.428571428571429,1.70512820512821
16,"Sand King",72,"Gyrocopter",76,79,155,0.490322580645161,1.98717948717949
16,"Sand King",73,"Alchemist",105,123,228,0.460526315789474,2.92307692307692
16,"Sand King",74,"Invoker",139,155,294,0.472789115646259,3.76923076923077
16,"Sand King",75,"Silencer",85,70,155,0.548387096774194,1.98717948717949
16,"Sand King",76,"Outworld Devourer",24,22,46,0.521739130434783,0.58974358974359
16,"Sand King",77,"Lycan",9,5,14,0.642857142857143,0.179487179487179
16,"Sand King",78,"Brewmaster",11,11,22,0.5,0.282051282051282
16,"Sand King",79,"Shadow Demon",9,10,19,0.473684210526316,0.243589743589744
16,"Sand King",80,"Lone Druid",8,15,23,0.347826086956522,0.294871794871795
16,"Sand King",81,"Chaos Knight",26,26,52,0.5,0.666666666666667
16,"Sand King",82,"Meepo",22,10,32,0.6875,0.41025641025641
16,"Sand King",83,"Treant Protector",15,15,30,0.5,0.384615384615385
16,"Sand King",84,"Ogre Magi",26,42,68,0.382352941176471,0.871794871794872
16,"Sand King",85,"Undying",51,39,90,0.566666666666667,1.15384615384615
16,"Sand King",86,"Rubick",59,95,154,0.383116883116883,1.97435897435897
16,"Sand King",87,"Disruptor",44,39,83,0.530120481927711,1.06410256410256
16,"Sand King",88,"Nyx Assassin",25,26,51,0.490196078431373,0.653846153846154
16,"Sand King",89,"Naga Siren",13,17,30,0.433333333333333,0.384615384615385
16,"Sand King",90,"Keeper of the Light",19,22,41,0.463414634146341,0.525641025641026
16,"Sand King",91,"Io",9,13,22,0.409090909090909,0.282051282051282
16,"Sand King",92,"Visage",6,6,12,0.5,0.153846153846154
16,"Sand King",93,"Slark",80,102,182,0.43956043956044,2.33333333333333
16,"Sand King",94,"Medusa",40,37,77,0.519480519480519,0.987179487179487
16,"Sand King",95,"Troll Warlord",21,27,48,0.4375,0.615384615384615
16,"Sand King",96,"Centaur Warrunner",17,19,36,0.472222222222222,0.461538461538462
16,"Sand King",97,"Magnus",38,44,82,0.463414634146341,1.05128205128205
16,"Sand King",98,"Timbersaw",46,47,93,0.494623655913978,1.19230769230769
16,"Sand King",99,"Bristleback",35,56,91,0.384615384615385,1.16666666666667
16,"Sand King",100,"Tusk",78,103,181,0.430939226519337,2.32051282051282
16,"Sand King",101,"Skywrath Mage",14,44,58,0.241379310344828,0.743589743589744
16,"Sand King",102,"Abaddon",38,33,71,0.535211267605634,0.91025641025641
16,"Sand King",103,"Elder Titan",9,9,18,0.5,0.230769230769231
16,"Sand King",104,"Legion Commander",83,87,170,0.488235294117647,2.17948717948718
16,"Sand King",105,"Techies",6,7,13,0.461538461538462,0.166666666666667
16,"Sand King",106,"Ember Spirit",73,105,178,0.410112359550562,2.28205128205128
16,"Sand King",107,"Earth Spirit",27,32,59,0.457627118644068,0.756410256410256
16,"Sand King",109,"Terrorblade",15,19,34,0.441176470588235,0.435897435897436
16,"Sand King",110,"Phoenix",27,31,58,0.46551724137931,0.743589743589744
16,"Sand King",111,"Oracle",7,12,19,0.368421052631579,0.243589743589744
16,"Sand King",112,"Winter Wyvern",56,69,125,0.448,1.6025641025641
17,"Storm Spirit",18,"Sven",38,29,67,0.567164179104478,0.858974358974359
17,"Storm Spirit",19,"Tiny",26,53,79,0.329113924050633,1.01282051282051
17,"Storm Spirit",20,"Vengeful Spirit",32,40,72,0.444444444444444,0.923076923076923
17,"Storm Spirit",21,"Windranger",110,147,257,0.428015564202335,3.29487179487179
17,"Storm Spirit",22,"Zeus",31,24,55,0.563636363636364,0.705128205128205
17,"Storm Spirit",23,"Kunkka",14,26,40,0.35,0.512820512820513
17,"Storm Spirit",25,"Lina",36,82,118,0.305084745762712,1.51282051282051
17,"Storm Spirit",26,"Lion",52,81,133,0.390977443609023,1.70512820512821
17,"Storm Spirit",27,"Shadow Shaman",29,27,56,0.517857142857143,0.717948717948718
17,"Storm Spirit",28,"Slardar",94,98,192,0.489583333333333,2.46153846153846
17,"Storm Spirit",29,"Tidehunter",20,31,51,0.392156862745098,0.653846153846154
17,"Storm Spirit",30,"Witch Doctor",57,82,139,0.410071942446043,1.78205128205128
17,"Storm Spirit",31,"Lich",42,38,80,0.525,1.02564102564103
17,"Storm Spirit",32,"Riki",47,42,89,0.528089887640449,1.14102564102564
17,"Storm Spirit",33,"Enigma",14,29,43,0.325581395348837,0.551282051282051
17,"Storm Spirit",34,"Tinker",4,10,14,0.285714285714286,0.179487179487179
17,"Storm Spirit",35,"Sniper",20,47,67,0.298507462686567,0.858974358974359
17,"Storm Spirit",36,"Necrophos",55,60,115,0.478260869565217,1.47435897435897
17,"Storm Spirit",37,"Warlock",20,15,35,0.571428571428571,0.448717948717949
17,"Storm Spirit",38,"Beastmaster",6,13,19,0.315789473684211,0.243589743589744
17,"Storm Spirit",39,"Queen of Pain",21,39,60,0.35,0.769230769230769
17,"Storm Spirit",40,"Venomancer",20,41,61,0.327868852459016,0.782051282051282
17,"Storm Spirit",41,"Faceless Void",25,32,57,0.43859649122807,0.730769230769231
17,"Storm Spirit",42,"Wraith King",52,59,111,0.468468468468468,1.42307692307692
17,"Storm Spirit",43,"Death Prophet",8,7,15,0.533333333333333,0.192307692307692
17,"Storm Spirit",44,"Phantom Assassin",52,104,156,0.333333333333333,2
17,"Storm Spirit",45,"Pugna",11,10,21,0.523809523809524,0.269230769230769
17,"Storm Spirit",46,"Templar Assassin",14,23,37,0.378378378378378,0.474358974358974
17,"Storm Spirit",47,"Viper",13,23,36,0.361111111111111,0.461538461538462
17,"Storm Spirit",48,"Luna",15,24,39,0.384615384615385,0.5
17,"Storm Spirit",49,"Dragon Knight",6,18,24,0.25,0.307692307692308
17,"Storm Spirit",50,"Dazzle",68,72,140,0.485714285714286,1.79487179487179
17,"Storm Spirit",51,"Clockwerk",40,38,78,0.512820512820513,1
17,"Storm Spirit",52,"Leshrac",10,8,18,0.555555555555556,0.230769230769231
17,"Storm Spirit",53,"Nature's Prophet",17,53,70,0.242857142857143,0.897435897435897
17,"Storm Spirit",54,"Lifestealer",28,42,70,0.4,0.897435897435897
17,"Storm Spirit",55,"Dark Seer",30,30,60,0.5,0.769230769230769
17,"Storm Spirit",56,"Clinkz",17,31,48,0.354166666666667,0.615384615384615
17,"Storm Spirit",57,"Omniknight",52,53,105,0.495238095238095,1.34615384615385
17,"Storm Spirit",58,"Enchantress",7,12,19,0.368421052631579,0.243589743589744
17,"Storm Spirit",59,"Huskar",25,42,67,0.373134328358209,0.858974358974359
17,"Storm Spirit",60,"Night Stalker",15,34,49,0.306122448979592,0.628205128205128
17,"Storm Spirit",61,"Broodmother",16,24,40,0.4,0.512820512820513
17,"Storm Spirit",62,"Bounty Hunter",62,64,126,0.492063492063492,1.61538461538462
17,"Storm Spirit",63,"Weaver",19,37,56,0.339285714285714,0.717948717948718
17,"Storm Spirit",64,"Jakiro",25,23,48,0.520833333333333,0.615384615384615
17,"Storm Spirit",65,"Batrider",6,11,17,0.352941176470588,0.217948717948718
17,"Storm Spirit",66,"Chen",11,11,22,0.5,0.282051282051282
17,"Storm Spirit",67,"Spectre",60,61,121,0.495867768595041,1.55128205128205
17,"Storm Spirit",68,"Ancient Apparition",53,58,111,0.477477477477477,1.42307692307692
17,"Storm Spirit",69,"Doom",57,91,148,0.385135135135135,1.8974358974359
17,"Storm Spirit",70,"Ursa",57,48,105,0.542857142857143,1.34615384615385
17,"Storm Spirit",71,"Spirit Breaker",64,76,140,0.457142857142857,1.79487179487179
17,"Storm Spirit",72,"Gyrocopter",41,56,97,0.422680412371134,1.24358974358974
17,"Storm Spirit",73,"Alchemist",40,62,102,0.392156862745098,1.30769230769231
17,"Storm Spirit",74,"Invoker",47,50,97,0.484536082474227,1.24358974358974
17,"Storm Spirit",75,"Silencer",69,88,157,0.439490445859873,2.01282051282051
17,"Storm Spirit",76,"Outworld Devourer",2,13,15,0.133333333333333,0.192307692307692
17,"Storm Spirit",77,"Lycan",8,18,26,0.307692307692308,0.333333333333333
17,"Storm Spirit",78,"Brewmaster",8,13,21,0.380952380952381,0.269230769230769
17,"Storm Spirit",79,"Shadow Demon",8,19,27,0.296296296296296,0.346153846153846
17,"Storm Spirit",80,"Lone Druid",8,6,14,0.571428571428571,0.179487179487179
17,"Storm Spirit",81,"Chaos Knight",21,29,50,0.42,0.641025641025641
17,"Storm Spirit",82,"Meepo",7,13,20,0.35,0.256410256410256
17,"Storm Spirit",83,"Treant Protector",7,20,27,0.259259259259259,0.346153846153846
17,"Storm Spirit",84,"Ogre Magi",38,47,85,0.447058823529412,1.08974358974359
17,"Storm Spirit",85,"Undying",52,43,95,0.547368421052632,1.21794871794872
17,"Storm Spirit",86,"Rubick",42,101,143,0.293706293706294,1.83333333333333
17,"Storm Spirit",87,"Disruptor",33,48,81,0.407407407407407,1.03846153846154
17,"Storm Spirit",88,"Nyx Assassin",17,28,45,0.377777777777778,0.576923076923077
17,"Storm Spirit",89,"Naga Siren",3,14,17,0.176470588235294,0.217948717948718
17,"Storm Spirit",90,"Keeper of the Light",23,25,48,0.479166666666667,0.615384615384615
17,"Storm Spirit",91,"Io",6,34,40,0.15,0.512820512820513
17,"Storm Spirit",92,"Visage",3,5,8,0.375,0.102564102564103
17,"Storm Spirit",93,"Slark",68,78,146,0.465753424657534,1.87179487179487
17,"Storm Spirit",94,"Medusa",27,20,47,0.574468085106383,0.602564102564103
17,"Storm Spirit",95,"Troll Warlord",17,22,39,0.435897435897436,0.5
17,"Storm Spirit",96,"Centaur Warrunner",16,21,37,0.432432432432432,0.474358974358974
17,"Storm Spirit",97,"Magnus",15,23,38,0.394736842105263,0.487179487179487
17,"Storm Spirit",98,"Timbersaw",24,38,62,0.387096774193548,0.794871794871795
17,"Storm Spirit",99,"Bristleback",38,49,87,0.436781609195402,1.11538461538462
17,"Storm Spirit",100,"Tusk",68,97,165,0.412121212121212,2.11538461538462
17,"Storm Spirit",101,"Skywrath Mage",16,29,45,0.355555555555556,0.576923076923077
17,"Storm Spirit",102,"Abaddon",25,35,60,0.416666666666667,0.769230769230769
17,"Storm Spirit",103,"Elder Titan",4,6,10,0.4,0.128205128205128
17,"Storm Spirit",104,"Legion Commander",76,130,206,0.368932038834951,2.64102564102564
17,"Storm Spirit",105,"Techies",9,18,27,0.333333333333333,0.346153846153846
17,"Storm Spirit",106,"Ember Spirit",17,41,58,0.293103448275862,0.743589743589744
17,"Storm Spirit",107,"Earth Spirit",18,27,45,0.4,0.576923076923077
17,"Storm Spirit",109,"Terrorblade",10,14,24,0.416666666666667,0.307692307692308
17,"Storm Spirit",110,"Phoenix",18,23,41,0.439024390243902,0.525641025641026
17,"Storm Spirit",111,"Oracle",3,9,12,0.25,0.153846153846154
17,"Storm Spirit",112,"Winter Wyvern",39,80,119,0.327731092436975,1.52564102564103
18,"Sven",19,"Tiny",44,40,84,0.523809523809524,1.07692307692308
18,"Sven",20,"Vengeful Spirit",76,63,139,0.546762589928058,1.78205128205128
18,"Sven",21,"Windranger",252,266,518,0.486486486486487,6.64102564102564
18,"Sven",22,"Zeus",66,71,137,0.481751824817518,1.75641025641026
18,"Sven",23,"Kunkka",21,32,53,0.39622641509434,0.67948717948718
18,"Sven",25,"Lina",102,140,242,0.421487603305785,3.1025641025641
18,"Sven",26,"Lion",103,106,209,0.492822966507177,2.67948717948718
18,"Sven",27,"Shadow Shaman",49,42,91,0.538461538461538,1.16666666666667
18,"Sven",28,"Slardar",129,78,207,0.623188405797101,2.65384615384615
18,"Sven",29,"Tidehunter",43,29,72,0.597222222222222,0.923076923076923
18,"Sven",30,"Witch Doctor",114,98,212,0.537735849056604,2.71794871794872
18,"Sven",31,"Lich",83,45,128,0.6484375,1.64102564102564
18,"Sven",32,"Riki",55,33,88,0.625,1.12820512820513
18,"Sven",33,"Enigma",46,47,93,0.494623655913978,1.19230769230769
18,"Sven",34,"Tinker",31,36,67,0.462686567164179,0.858974358974359
18,"Sven",35,"Sniper",44,63,107,0.411214953271028,1.37179487179487
18,"Sven",36,"Necrophos",102,78,180,0.566666666666667,2.30769230769231
18,"Sven",37,"Warlock",36,30,66,0.545454545454545,0.846153846153846
18,"Sven",38,"Beastmaster",18,13,31,0.580645161290323,0.397435897435897
18,"Sven",39,"Queen of Pain",122,153,275,0.443636363636364,3.52564102564103
18,"Sven",40,"Venomancer",48,49,97,0.494845360824742,1.24358974358974
18,"Sven",41,"Faceless Void",10,13,23,0.434782608695652,0.294871794871795
18,"Sven",42,"Wraith King",44,32,76,0.578947368421053,0.974358974358974
18,"Sven",43,"Death Prophet",36,18,54,0.666666666666667,0.692307692307692
18,"Sven",44,"Phantom Assassin",34,50,84,0.404761904761905,1.07692307692308
18,"Sven",45,"Pugna",18,26,44,0.409090909090909,0.564102564102564
18,"Sven",46,"Templar Assassin",73,70,143,0.510489510489511,1.83333333333333
18,"Sven",47,"Viper",59,48,107,0.551401869158878,1.37179487179487
18,"Sven",48,"Luna",19,9,28,0.678571428571429,0.358974358974359
18,"Sven",49,"Dragon Knight",22,16,38,0.578947368421053,0.487179487179487
18,"Sven",50,"Dazzle",113,101,214,0.52803738317757,2.74358974358974
18,"Sven",51,"Clockwerk",43,42,85,0.505882352941176,1.08974358974359
18,"Sven",52,"Leshrac",22,21,43,0.511627906976744,0.551282051282051
18,"Sven",53,"Nature's Prophet",29,66,95,0.305263157894737,1.21794871794872
18,"Sven",54,"Lifestealer",15,21,36,0.416666666666667,0.461538461538462
18,"Sven",55,"Dark Seer",85,61,146,0.582191780821918,1.87179487179487
18,"Sven",56,"Clinkz",25,32,57,0.43859649122807,0.730769230769231
18,"Sven",57,"Omniknight",122,66,188,0.648936170212766,2.41025641025641
18,"Sven",58,"Enchantress",11,22,33,0.333333333333333,0.423076923076923
18,"Sven",59,"Huskar",40,32,72,0.555555555555556,0.923076923076923
18,"Sven",60,"Night Stalker",32,29,61,0.524590163934426,0.782051282051282
18,"Sven",61,"Broodmother",14,19,33,0.424242424242424,0.423076923076923
18,"Sven",62,"Bounty Hunter",81,85,166,0.487951807228916,2.12820512820513
18,"Sven",63,"Weaver",26,31,57,0.456140350877193,0.730769230769231
18,"Sven",64,"Jakiro",38,46,84,0.452380952380952,1.07692307692308
18,"Sven",65,"Batrider",5,14,19,0.263157894736842,0.243589743589744
18,"Sven",66,"Chen",8,9,17,0.470588235294118,0.217948717948718
18,"Sven",67,"Spectre",46,25,71,0.647887323943662,0.91025641025641
18,"Sven",68,"Ancient Apparition",99,80,179,0.553072625698324,2.29487179487179
18,"Sven",69,"Doom",103,74,177,0.581920903954802,2.26923076923077
18,"Sven",70,"Ursa",39,34,73,0.534246575342466,0.935897435897436
18,"Sven",71,"Spirit Breaker",73,67,140,0.521428571428571,1.79487179487179
18,"Sven",72,"Gyrocopter",28,51,79,0.354430379746835,1.01282051282051
18,"Sven",73,"Alchemist",113,111,224,0.504464285714286,2.87179487179487
18,"Sven",74,"Invoker",150,164,314,0.477707006369427,4.02564102564103
18,"Sven",75,"Silencer",116,95,211,0.549763033175355,2.70512820512821
18,"Sven",76,"Outworld Devourer",21,15,36,0.583333333333333,0.461538461538462
18,"Sven",77,"Lycan",13,16,29,0.448275862068966,0.371794871794872
18,"Sven",78,"Brewmaster",14,13,27,0.518518518518518,0.346153846153846
18,"Sven",79,"Shadow Demon",12,18,30,0.4,0.384615384615385
18,"Sven",80,"Lone Druid",6,10,16,0.375,0.205128205128205
18,"Sven",81,"Chaos Knight",13,14,27,0.481481481481481,0.346153846153846
18,"Sven",82,"Meepo",16,22,38,0.421052631578947,0.487179487179487
18,"Sven",83,"Treant Protector",25,31,56,0.446428571428571,0.717948717948718
18,"Sven",84,"Ogre Magi",56,59,115,0.48695652173913,1.47435897435897
18,"Sven",85,"Undying",98,56,154,0.636363636363636,1.97435897435897
18,"Sven",86,"Rubick",78,99,177,0.440677966101695,2.26923076923077
18,"Sven",87,"Disruptor",64,78,142,0.450704225352113,1.82051282051282
18,"Sven",88,"Nyx Assassin",25,40,65,0.384615384615385,0.833333333333333
18,"Sven",89,"Naga Siren",8,9,17,0.470588235294118,0.217948717948718
18,"Sven",90,"Keeper of the Light",39,35,74,0.527027027027027,0.948717948717949
18,"Sven",91,"Io",36,32,68,0.529411764705882,0.871794871794872
18,"Sven",92,"Visage",6,14,20,0.3,0.256410256410256
18,"Sven",93,"Slark",59,50,109,0.541284403669725,1.3974358974359
18,"Sven",94,"Medusa",30,13,43,0.697674418604651,0.551282051282051
18,"Sven",95,"Troll Warlord",14,19,33,0.424242424242424,0.423076923076923
18,"Sven",96,"Centaur Warrunner",20,25,45,0.444444444444444,0.576923076923077
18,"Sven",97,"Magnus",89,98,187,0.475935828877005,2.3974358974359
18,"Sven",98,"Timbersaw",37,46,83,0.44578313253012,1.06410256410256
18,"Sven",99,"Bristleback",36,48,84,0.428571428571429,1.07692307692308
18,"Sven",100,"Tusk",122,122,244,0.5,3.12820512820513
18,"Sven",101,"Skywrath Mage",26,51,77,0.337662337662338,0.987179487179487
18,"Sven",102,"Abaddon",38,32,70,0.542857142857143,0.897435897435897
18,"Sven",103,"Elder Titan",15,12,27,0.555555555555556,0.346153846153846
18,"Sven",104,"Legion Commander",85,69,154,0.551948051948052,1.97435897435897
18,"Sven",105,"Techies",17,20,37,0.459459459459459,0.474358974358974
18,"Sven",106,"Ember Spirit",71,74,145,0.489655172413793,1.85897435897436
18,"Sven",107,"Earth Spirit",34,34,68,0.5,0.871794871794872
18,"Sven",109,"Terrorblade",10,14,24,0.416666666666667,0.307692307692308
18,"Sven",110,"Phoenix",41,38,79,0.518987341772152,1.01282051282051
18,"Sven",111,"Oracle",13,13,26,0.5,0.333333333333333
18,"Sven",112,"Winter Wyvern",100,108,208,0.480769230769231,2.66666666666667
19,"Tiny",20,"Vengeful Spirit",95,74,169,0.562130177514793,2.16666666666667
19,"Tiny",21,"Windranger",364,450,814,0.447174447174447,10.4358974358974
19,"Tiny",22,"Zeus",85,72,157,0.54140127388535,2.01282051282051
19,"Tiny",23,"Kunkka",28,51,79,0.354430379746835,1.01282051282051
19,"Tiny",25,"Lina",115,175,290,0.396551724137931,3.71794871794872
19,"Tiny",26,"Lion",160,171,331,0.483383685800604,4.24358974358974
19,"Tiny",27,"Shadow Shaman",69,69,138,0.5,1.76923076923077
19,"Tiny",28,"Slardar",207,170,377,0.549071618037135,4.83333333333333
19,"Tiny",29,"Tidehunter",28,40,68,0.411764705882353,0.871794871794872
19,"Tiny",30,"Witch Doctor",153,153,306,0.5,3.92307692307692
19,"Tiny",31,"Lich",92,86,178,0.51685393258427,2.28205128205128
19,"Tiny",32,"Riki",99,82,181,0.546961325966851,2.32051282051282
19,"Tiny",33,"Enigma",49,58,107,0.457943925233645,1.37179487179487
19,"Tiny",34,"Tinker",30,51,81,0.37037037037037,1.03846153846154
19,"Tiny",35,"Sniper",59,70,129,0.457364341085271,1.65384615384615
19,"Tiny",36,"Necrophos",116,114,230,0.504347826086956,2.94871794871795
19,"Tiny",37,"Warlock",36,32,68,0.529411764705882,0.871794871794872
19,"Tiny",38,"Beastmaster",28,21,49,0.571428571428571,0.628205128205128
19,"Tiny",39,"Queen of Pain",140,199,339,0.412979351032448,4.34615384615385
19,"Tiny",40,"Venomancer",60,66,126,0.476190476190476,1.61538461538462
19,"Tiny",41,"Faceless Void",26,51,77,0.337662337662338,0.987179487179487
19,"Tiny",42,"Wraith King",115,98,213,0.539906103286385,2.73076923076923
19,"Tiny",43,"Death Prophet",38,25,63,0.603174603174603,0.807692307692308
19,"Tiny",44,"Phantom Assassin",114,127,241,0.473029045643154,3.08974358974359
19,"Tiny",45,"Pugna",27,32,59,0.457627118644068,0.756410256410256
19,"Tiny",46,"Templar Assassin",69,96,165,0.418181818181818,2.11538461538462
19,"Tiny",47,"Viper",64,58,122,0.524590163934426,1.56410256410256
19,"Tiny",48,"Luna",40,32,72,0.555555555555556,0.923076923076923
19,"Tiny",49,"Dragon Knight",22,40,62,0.354838709677419,0.794871794871795
19,"Tiny",50,"Dazzle",171,142,313,0.546325878594249,4.01282051282051
19,"Tiny",51,"Clockwerk",85,77,162,0.524691358024691,2.07692307692308
19,"Tiny",52,"Leshrac",12,32,44,0.272727272727273,0.564102564102564
19,"Tiny",53,"Nature's Prophet",63,95,158,0.39873417721519,2.02564102564103
19,"Tiny",54,"Lifestealer",38,41,79,0.481012658227848,1.01282051282051
19,"Tiny",55,"Dark Seer",72,85,157,0.45859872611465,2.01282051282051
19,"Tiny",56,"Clinkz",25,67,92,0.271739130434783,1.17948717948718
19,"Tiny",57,"Omniknight",135,94,229,0.589519650655022,2.93589743589744
19,"Tiny",58,"Enchantress",17,23,40,0.425,0.512820512820513
19,"Tiny",59,"Huskar",52,77,129,0.403100775193798,1.65384615384615
19,"Tiny",60,"Night Stalker",45,46,91,0.494505494505495,1.16666666666667
19,"Tiny",61,"Broodmother",24,32,56,0.428571428571429,0.717948717948718
19,"Tiny",62,"Bounty Hunter",133,148,281,0.473309608540925,3.6025641025641
19,"Tiny",63,"Weaver",44,45,89,0.49438202247191,1.14102564102564
19,"Tiny",64,"Jakiro",53,70,123,0.430894308943089,1.57692307692308
19,"Tiny",65,"Batrider",17,15,32,0.53125,0.41025641025641
19,"Tiny",66,"Chen",12,5,17,0.705882352941177,0.217948717948718
19,"Tiny",67,"Spectre",101,75,176,0.573863636363636,2.25641025641026
19,"Tiny",68,"Ancient Apparition",134,152,286,0.468531468531469,3.66666666666667
19,"Tiny",69,"Doom",146,127,273,0.534798534798535,3.5
19,"Tiny",70,"Ursa",87,60,147,0.591836734693878,1.88461538461538
19,"Tiny",71,"Spirit Breaker",116,131,247,0.469635627530364,3.16666666666667
19,"Tiny",72,"Gyrocopter",90,104,194,0.463917525773196,2.48717948717949
19,"Tiny",73,"Alchemist",150,159,309,0.485436893203884,3.96153846153846
19,"Tiny",74,"Invoker",164,198,362,0.453038674033149,4.64102564102564
19,"Tiny",75,"Silencer",168,155,323,0.520123839009288,4.14102564102564
19,"Tiny",76,"Outworld Devourer",14,36,50,0.28,0.641025641025641
19,"Tiny",77,"Lycan",21,17,38,0.552631578947368,0.487179487179487
19,"Tiny",78,"Brewmaster",10,15,25,0.4,0.320512820512821
19,"Tiny",79,"Shadow Demon",13,41,54,0.240740740740741,0.692307692307692
19,"Tiny",80,"Lone Druid",12,19,31,0.387096774193548,0.397435897435897
19,"Tiny",81,"Chaos Knight",34,30,64,0.53125,0.82051282051282
19,"Tiny",82,"Meepo",25,37,62,0.403225806451613,0.794871794871795
19,"Tiny",83,"Treant Protector",24,36,60,0.4,0.769230769230769
19,"Tiny",84,"Ogre Magi",81,85,166,0.487951807228916,2.12820512820513
19,"Tiny",85,"Undying",111,109,220,0.504545454545455,2.82051282051282
19,"Tiny",86,"Rubick",133,212,345,0.385507246376812,4.42307692307692
19,"Tiny",87,"Disruptor",82,99,181,0.453038674033149,2.32051282051282
19,"Tiny",88,"Nyx Assassin",60,49,109,0.55045871559633,1.3974358974359
19,"Tiny",89,"Naga Siren",13,22,35,0.371428571428571,0.448717948717949
19,"Tiny",90,"Keeper of the Light",55,74,129,0.426356589147287,1.65384615384615
19,"Tiny",91,"Io",198,259,457,0.433260393873085,5.85897435897436
19,"Tiny",92,"Visage",21,16,37,0.567567567567568,0.474358974358974
19,"Tiny",93,"Slark",116,123,239,0.485355648535565,3.06410256410256
19,"Tiny",94,"Medusa",43,30,73,0.589041095890411,0.935897435897436
19,"Tiny",95,"Troll Warlord",33,34,67,0.492537313432836,0.858974358974359
19,"Tiny",96,"Centaur Warrunner",40,54,94,0.425531914893617,1.20512820512821
19,"Tiny",97,"Magnus",54,66,120,0.45,1.53846153846154
19,"Tiny",98,"Timbersaw",48,63,111,0.432432432432432,1.42307692307692
19,"Tiny",99,"Bristleback",50,73,123,0.40650406504065,1.57692307692308
19,"Tiny",100,"Tusk",181,213,394,0.459390862944162,5.05128205128205
19,"Tiny",101,"Skywrath Mage",53,57,110,0.481818181818182,1.41025641025641
19,"Tiny",102,"Abaddon",78,55,133,0.586466165413534,1.70512820512821
19,"Tiny",103,"Elder Titan",17,16,33,0.515151515151515,0.423076923076923
19,"Tiny",104,"Legion Commander",149,165,314,0.474522292993631,4.02564102564103
19,"Tiny",105,"Techies",37,36,73,0.506849315068493,0.935897435897436
19,"Tiny",106,"Ember Spirit",102,125,227,0.449339207048458,2.91025641025641
19,"Tiny",107,"Earth Spirit",37,53,90,0.411111111111111,1.15384615384615
19,"Tiny",109,"Terrorblade",29,22,51,0.568627450980392,0.653846153846154
19,"Tiny",110,"Phoenix",58,61,119,0.487394957983193,1.52564102564103
19,"Tiny",111,"Oracle",16,22,38,0.421052631578947,0.487179487179487
19,"Tiny",112,"Winter Wyvern",148,143,291,0.508591065292096,3.73076923076923
20,"Vengeful Spirit",21,"Windranger",342,332,674,0.507418397626113,8.64102564102564
20,"Vengeful Spirit",22,"Zeus",53,70,123,0.430894308943089,1.57692307692308
20,"Vengeful Spirit",23,"Kunkka",31,39,70,0.442857142857143,0.897435897435897
20,"Vengeful Spirit",25,"Lina",110,123,233,0.472103004291845,2.98717948717949
20,"Vengeful Spirit",26,"Lion",58,51,109,0.532110091743119,1.3974358974359
20,"Vengeful Spirit",27,"Shadow Shaman",30,22,52,0.576923076923077,0.666666666666667
20,"Vengeful Spirit",28,"Slardar",258,191,449,0.574610244988864,5.75641025641026
20,"Vengeful Spirit",29,"Tidehunter",36,30,66,0.545454545454545,0.846153846153846
20,"Vengeful Spirit",30,"Witch Doctor",65,63,128,0.5078125,1.64102564102564
20,"Vengeful Spirit",31,"Lich",63,42,105,0.6,1.34615384615385
20,"Vengeful Spirit",32,"Riki",83,46,129,0.643410852713178,1.65384615384615
20,"Vengeful Spirit",33,"Enigma",29,26,55,0.527272727272727,0.705128205128205
20,"Vengeful Spirit",34,"Tinker",42,40,82,0.51219512195122,1.05128205128205
20,"Vengeful Spirit",35,"Sniper",65,62,127,0.511811023622047,1.62820512820513
20,"Vengeful Spirit",36,"Necrophos",93,52,145,0.641379310344828,1.85897435897436
20,"Vengeful Spirit",37,"Warlock",26,15,41,0.634146341463415,0.525641025641026
20,"Vengeful Spirit",38,"Beastmaster",22,16,38,0.578947368421053,0.487179487179487
20,"Vengeful Spirit",39,"Queen of Pain",157,185,342,0.45906432748538,4.38461538461539
20,"Vengeful Spirit",40,"Venomancer",34,29,63,0.53968253968254,0.807692307692308
20,"Vengeful Spirit",41,"Faceless Void",42,60,102,0.411764705882353,1.30769230769231
20,"Vengeful Spirit",42,"Wraith King",177,108,285,0.621052631578947,3.65384615384615
20,"Vengeful Spirit",43,"Death Prophet",30,22,52,0.576923076923077,0.666666666666667
20,"Vengeful Spirit",44,"Phantom Assassin",120,129,249,0.481927710843373,3.19230769230769
20,"Vengeful Spirit",45,"Pugna",16,15,31,0.516129032258065,0.397435897435897
20,"Vengeful Spirit",46,"Templar Assassin",117,95,212,0.55188679245283,2.71794871794872
20,"Vengeful Spirit",47,"Viper",66,62,128,0.515625,1.64102564102564
20,"Vengeful Spirit",48,"Luna",56,56,112,0.5,1.43589743589744
20,"Vengeful Spirit",49,"Dragon Knight",43,30,73,0.589041095890411,0.935897435897436
20,"Vengeful Spirit",50,"Dazzle",91,64,155,0.587096774193548,1.98717948717949
20,"Vengeful Spirit",51,"Clockwerk",76,75,151,0.503311258278146,1.93589743589744
20,"Vengeful Spirit",52,"Leshrac",15,19,34,0.441176470588235,0.435897435897436
20,"Vengeful Spirit",53,"Nature's Prophet",45,58,103,0.436893203883495,1.32051282051282
20,"Vengeful Spirit",54,"Lifestealer",42,40,82,0.51219512195122,1.05128205128205
20,"Vengeful Spirit",55,"Dark Seer",66,53,119,0.554621848739496,1.52564102564103
20,"Vengeful Spirit",56,"Clinkz",39,42,81,0.481481481481481,1.03846153846154
20,"Vengeful Spirit",57,"Omniknight",75,40,115,0.652173913043478,1.47435897435897
20,"Vengeful Spirit",58,"Enchantress",7,17,24,0.291666666666667,0.307692307692308
20,"Vengeful Spirit",59,"Huskar",41,42,83,0.493975903614458,1.06410256410256
20,"Vengeful Spirit",60,"Night Stalker",62,47,109,0.568807339449541,1.3974358974359
20,"Vengeful Spirit",61,"Broodmother",20,17,37,0.540540540540541,0.474358974358974
20,"Vengeful Spirit",62,"Bounty Hunter",86,84,170,0.505882352941176,2.17948717948718
20,"Vengeful Spirit",63,"Weaver",44,51,95,0.463157894736842,1.21794871794872
20,"Vengeful Spirit",64,"Jakiro",33,24,57,0.578947368421053,0.730769230769231
20,"Vengeful Spirit",65,"Batrider",16,21,37,0.432432432432432,0.474358974358974
20,"Vengeful Spirit",66,"Chen",3,4,7,0.428571428571429,0.0897435897435897
20,"Vengeful Spirit",67,"Spectre",121,78,199,0.608040201005025,2.55128205128205
20,"Vengeful Spirit",68,"Ancient Apparition",73,76,149,0.48993288590604,1.91025641025641
20,"Vengeful Spirit",69,"Doom",141,116,257,0.54863813229572,3.29487179487179
20,"Vengeful Spirit",70,"Ursa",59,69,128,0.4609375,1.64102564102564
20,"Vengeful Spirit",71,"Spirit Breaker",104,91,195,0.533333333333333,2.5
20,"Vengeful Spirit",72,"Gyrocopter",128,90,218,0.587155963302752,2.79487179487179
20,"Vengeful Spirit",73,"Alchemist",173,135,308,0.561688311688312,3.94871794871795
20,"Vengeful Spirit",74,"Invoker",200,157,357,0.560224089635854,4.57692307692308
20,"Vengeful Spirit",75,"Silencer",87,85,172,0.505813953488372,2.20512820512821
20,"Vengeful Spirit",76,"Outworld Devourer",26,26,52,0.5,0.666666666666667
20,"Vengeful Spirit",77,"Lycan",13,16,29,0.448275862068966,0.371794871794872
20,"Vengeful Spirit",78,"Brewmaster",20,11,31,0.645161290322581,0.397435897435897
20,"Vengeful Spirit",79,"Shadow Demon",8,10,18,0.444444444444444,0.230769230769231
20,"Vengeful Spirit",80,"Lone Druid",20,14,34,0.588235294117647,0.435897435897436
20,"Vengeful Spirit",81,"Chaos Knight",52,37,89,0.584269662921348,1.14102564102564
20,"Vengeful Spirit",82,"Meepo",19,28,47,0.404255319148936,0.602564102564103
20,"Vengeful Spirit",83,"Treant Protector",34,18,52,0.653846153846154,0.666666666666667
20,"Vengeful Spirit",84,"Ogre Magi",43,47,90,0.477777777777778,1.15384615384615
20,"Vengeful Spirit",85,"Undying",91,55,146,0.623287671232877,1.87179487179487
20,"Vengeful Spirit",86,"Rubick",70,76,146,0.479452054794521,1.87179487179487
20,"Vengeful Spirit",87,"Disruptor",57,24,81,0.703703703703704,1.03846153846154
20,"Vengeful Spirit",88,"Nyx Assassin",39,32,71,0.549295774647887,0.91025641025641
20,"Vengeful Spirit",89,"Naga Siren",16,11,27,0.592592592592593,0.346153846153846
20,"Vengeful Spirit",90,"Keeper of the Light",28,24,52,0.538461538461538,0.666666666666667
20,"Vengeful Spirit",91,"Io",23,22,45,0.511111111111111,0.576923076923077
20,"Vengeful Spirit",92,"Visage",23,12,35,0.657142857142857,0.448717948717949
20,"Vengeful Spirit",93,"Slark",147,160,307,0.478827361563518,3.93589743589744
20,"Vengeful Spirit",94,"Medusa",51,25,76,0.671052631578947,0.974358974358974
20,"Vengeful Spirit",95,"Troll Warlord",37,31,68,0.544117647058823,0.871794871794872
20,"Vengeful Spirit",96,"Centaur Warrunner",30,29,59,0.508474576271186,0.756410256410256
20,"Vengeful Spirit",97,"Magnus",58,45,103,0.563106796116505,1.32051282051282
20,"Vengeful Spirit",98,"Timbersaw",45,56,101,0.445544554455446,1.29487179487179
20,"Vengeful Spirit",99,"Bristleback",64,62,126,0.507936507936508,1.61538461538462
20,"Vengeful Spirit",100,"Tusk",149,147,296,0.503378378378378,3.79487179487179
20,"Vengeful Spirit",101,"Skywrath Mage",24,39,63,0.380952380952381,0.807692307692308
20,"Vengeful Spirit",102,"Abaddon",40,47,87,0.459770114942529,1.11538461538462
20,"Vengeful Spirit",103,"Elder Titan",16,13,29,0.551724137931034,0.371794871794872
20,"Vengeful Spirit",104,"Legion Commander",135,129,264,0.511363636363636,3.38461538461538
20,"Vengeful Spirit",105,"Techies",16,11,27,0.592592592592593,0.346153846153846
20,"Vengeful Spirit",106,"Ember Spirit",118,118,236,0.5,3.02564102564103
20,"Vengeful Spirit",107,"Earth Spirit",34,38,72,0.472222222222222,0.923076923076923
20,"Vengeful Spirit",109,"Terrorblade",29,23,52,0.557692307692308,0.666666666666667
20,"Vengeful Spirit",110,"Phoenix",51,35,86,0.593023255813954,1.1025641025641
20,"Vengeful Spirit",111,"Oracle",10,7,17,0.588235294117647,0.217948717948718
20,"Vengeful Spirit",112,"Winter Wyvern",75,55,130,0.576923076923077,1.66666666666667
21,"Windranger",22,"Zeus",294,234,528,0.556818181818182,6.76923076923077
21,"Windranger",23,"Kunkka",154,197,351,0.438746438746439,4.5
21,"Windranger",25,"Lina",420,654,1074,0.391061452513966,13.7692307692308
21,"Windranger",26,"Lion",517,709,1226,0.421696574225122,15.7179487179487
21,"Windranger",27,"Shadow Shaman",293,272,565,0.51858407079646,7.24358974358974
21,"Windranger",28,"Slardar",1008,850,1858,0.542518837459634,23.8205128205128
21,"Windranger",29,"Tidehunter",149,177,326,0.457055214723926,4.17948717948718
21,"Windranger",30,"Witch Doctor",535,618,1153,0.464006938421509,14.7820512820513
21,"Windranger",31,"Lich",399,339,738,0.540650406504065,9.46153846153846
21,"Windranger",32,"Riki",322,278,600,0.536666666666667,7.69230769230769
21,"Windranger",33,"Enigma",201,226,427,0.470725995316159,5.47435897435897
21,"Windranger",34,"Tinker",103,152,255,0.403921568627451,3.26923076923077
21,"Windranger",35,"Sniper",158,240,398,0.396984924623116,5.1025641025641
21,"Windranger",36,"Necrophos",424,382,806,0.52605459057072,10.3333333333333
21,"Windranger",37,"Warlock",181,136,317,0.570977917981073,4.06410256410256
21,"Windranger",38,"Beastmaster",74,106,180,0.411111111111111,2.30769230769231
21,"Windranger",39,"Queen of Pain",454,684,1138,0.398945518453427,14.5897435897436
21,"Windranger",40,"Venomancer",246,194,440,0.559090909090909,5.64102564102564
21,"Windranger",41,"Faceless Void",218,286,504,0.432539682539683,6.46153846153846
21,"Windranger",42,"Wraith King",724,605,1329,0.54477050413845,17.0384615384615
21,"Windranger",43,"Death Prophet",95,91,186,0.510752688172043,2.38461538461538
21,"Windranger",44,"Phantom Assassin",455,622,1077,0.42246982358403,13.8076923076923
21,"Windranger",45,"Pugna",86,119,205,0.419512195121951,2.62820512820513
21,"Windranger",46,"Templar Assassin",269,315,584,0.460616438356164,7.48717948717949
21,"Windranger",47,"Viper",216,214,430,0.502325581395349,5.51282051282051
21,"Windranger",48,"Luna",184,168,352,0.522727272727273,4.51282051282051
21,"Windranger",49,"Dragon Knight",110,151,261,0.421455938697318,3.34615384615385
21,"Windranger",50,"Dazzle",711,711,1422,0.5,18.2307692307692
21,"Windranger",51,"Clockwerk",265,320,585,0.452991452991453,7.5
21,"Windranger",52,"Leshrac",75,119,194,0.38659793814433,2.48717948717949
21,"Windranger",53,"Nature's Prophet",221,334,555,0.398198198198198,7.11538461538461
21,"Windranger",54,"Lifestealer",177,236,413,0.428571428571429,5.29487179487179
21,"Windranger",55,"Dark Seer",270,277,547,0.493601462522852,7.01282051282051
21,"Windranger",56,"Clinkz",150,190,340,0.441176470588235,4.35897435897436
21,"Windranger",57,"Omniknight",497,396,893,0.556550951847704,11.4487179487179
21,"Windranger",58,"Enchantress",55,100,155,0.354838709677419,1.98717948717949
21,"Windranger",59,"Huskar",258,235,493,0.523326572008114,6.32051282051282
21,"Windranger",60,"Night Stalker",229,234,463,0.494600431965443,5.93589743589744
21,"Windranger",61,"Broodmother",61,105,166,0.367469879518072,2.12820512820513
21,"Windranger",62,"Bounty Hunter",594,605,1199,0.495412844036697,15.3717948717949
21,"Windranger",63,"Weaver",167,186,353,0.473087818696884,4.52564102564103
21,"Windranger",64,"Jakiro",214,237,451,0.47450110864745,5.78205128205128
21,"Windranger",65,"Batrider",69,76,145,0.475862068965517,1.85897435897436
21,"Windranger",66,"Chen",46,55,101,0.455445544554455,1.29487179487179
21,"Windranger",67,"Spectre",621,487,1108,0.560469314079422,14.2051282051282
21,"Windranger",68,"Ancient Apparition",529,575,1104,0.479166666666667,14.1538461538462
21,"Windranger",69,"Doom",619,651,1270,0.48740157480315,16.2820512820513
21,"Windranger",70,"Ursa",408,280,688,0.593023255813954,8.82051282051282
21,"Windranger",71,"Spirit Breaker",604,536,1140,0.529824561403509,14.6153846153846
21,"Windranger",72,"Gyrocopter",493,530,1023,0.481915933528837,13.1153846153846
21,"Windranger",73,"Alchemist",618,637,1255,0.492430278884462,16.0897435897436
21,"Windranger",74,"Invoker",572,701,1273,0.449332285938727,16.3205128205128
21,"Windranger",75,"Silencer",583,570,1153,0.505637467476149,14.7820512820513
21,"Windranger",76,"Outworld Devourer",74,109,183,0.404371584699454,2.34615384615385
21,"Windranger",77,"Lycan",80,79,159,0.50314465408805,2.03846153846154
21,"Windranger",78,"Brewmaster",58,72,130,0.446153846153846,1.66666666666667
21,"Windranger",79,"Shadow Demon",97,150,247,0.392712550607287,3.16666666666667
21,"Windranger",80,"Lone Druid",57,75,132,0.431818181818182,1.69230769230769
21,"Windranger",81,"Chaos Knight",156,188,344,0.453488372093023,4.41025641025641
21,"Windranger",82,"Meepo",101,122,223,0.452914798206278,2.85897435897436
21,"Windranger",83,"Treant Protector",148,142,290,0.510344827586207,3.71794871794872
21,"Windranger",84,"Ogre Magi",357,361,718,0.497214484679666,9.2051282051282
21,"Windranger",85,"Undying",537,415,952,0.564075630252101,12.2051282051282
21,"Windranger",86,"Rubick",596,827,1423,0.418833450456781,18.2435897435897
21,"Windranger",87,"Disruptor",416,354,770,0.54025974025974,9.87179487179487
21,"Windranger",88,"Nyx Assassin",182,227,409,0.444987775061125,5.24358974358974
21,"Windranger",89,"Naga Siren",60,68,128,0.46875,1.64102564102564
21,"Windranger",90,"Keeper of the Light",179,184,363,0.493112947658402,4.65384615384615
21,"Windranger",91,"Io",90,154,244,0.368852459016393,3.12820512820513
21,"Windranger",92,"Visage",82,80,162,0.506172839506173,2.07692307692308
21,"Windranger",93,"Slark",610,749,1359,0.448859455481972,17.4230769230769
21,"Windranger",94,"Medusa",166,170,336,0.494047619047619,4.30769230769231
21,"Windranger",95,"Troll Warlord",133,133,266,0.5,3.41025641025641
21,"Windranger",96,"Centaur Warrunner",128,120,248,0.516129032258065,3.17948717948718
21,"Windranger",97,"Magnus",154,187,341,0.451612903225806,4.37179487179487
21,"Windranger",98,"Timbersaw",181,192,373,0.485254691689008,4.78205128205128
21,"Windranger",99,"Bristleback",256,306,562,0.455516014234875,7.20512820512821
21,"Windranger",100,"Tusk",777,829,1606,0.483810709838107,20.5897435897436
21,"Windranger",101,"Skywrath Mage",198,271,469,0.422174840085288,6.01282051282051
21,"Windranger",102,"Abaddon",320,240,560,0.571428571428571,7.17948717948718
21,"Windranger",103,"Elder Titan",73,51,124,0.588709677419355,1.58974358974359
21,"Windranger",104,"Legion Commander",643,762,1405,0.457651245551601,18.0128205128205
21,"Windranger",105,"Techies",78,110,188,0.414893617021277,2.41025641025641
21,"Windranger",106,"Ember Spirit",435,525,960,0.453125,12.3076923076923
21,"Windranger",107,"Earth Spirit",224,212,436,0.513761467889908,5.58974358974359
21,"Windranger",109,"Terrorblade",118,108,226,0.52212389380531,2.8974358974359
21,"Windranger",110,"Phoenix",207,211,418,0.495215311004785,5.35897435897436
21,"Windranger",111,"Oracle",67,95,162,0.41358024691358,2.07692307692308
21,"Windranger",112,"Winter Wyvern",649,671,1320,0.491666666666667,16.9230769230769
22,"Zeus",23,"Kunkka",36,37,73,0.493150684931507,0.935897435897436
22,"Zeus",25,"Lina",83,94,177,0.468926553672316,2.26923076923077
22,"Zeus",26,"Lion",121,113,234,0.517094017094017,3
22,"Zeus",27,"Shadow Shaman",63,56,119,0.529411764705882,1.52564102564103
22,"Zeus",28,"Slardar",208,159,367,0.566757493188011,4.70512820512821
22,"Zeus",29,"Tidehunter",55,36,91,0.604395604395604,1.16666666666667
22,"Zeus",30,"Witch Doctor",146,101,247,0.591093117408907,3.16666666666667
22,"Zeus",31,"Lich",74,56,130,0.569230769230769,1.66666666666667
22,"Zeus",32,"Riki",117,74,191,0.612565445026178,2.44871794871795
22,"Zeus",33,"Enigma",52,41,93,0.559139784946237,1.19230769230769
22,"Zeus",34,"Tinker",23,19,42,0.547619047619048,0.538461538461538
22,"Zeus",35,"Sniper",67,77,144,0.465277777777778,1.84615384615385
22,"Zeus",36,"Necrophos",124,67,191,0.649214659685864,2.44871794871795
22,"Zeus",37,"Warlock",44,18,62,0.709677419354839,0.794871794871795
22,"Zeus",38,"Beastmaster",23,14,37,0.621621621621622,0.474358974358974
22,"Zeus",39,"Queen of Pain",96,101,197,0.487309644670051,2.52564102564103
22,"Zeus",40,"Venomancer",56,42,98,0.571428571428571,1.25641025641026
22,"Zeus",41,"Faceless Void",62,58,120,0.516666666666667,1.53846153846154
22,"Zeus",42,"Wraith King",182,95,277,0.657039711191336,3.55128205128205
22,"Zeus",43,"Death Prophet",16,14,30,0.533333333333333,0.384615384615385
22,"Zeus",44,"Phantom Assassin",153,132,285,0.536842105263158,3.65384615384615
22,"Zeus",45,"Pugna",35,25,60,0.583333333333333,0.769230769230769
22,"Zeus",46,"Templar Assassin",55,33,88,0.625,1.12820512820513
22,"Zeus",47,"Viper",61,44,105,0.580952380952381,1.34615384615385
22,"Zeus",48,"Luna",42,44,86,0.488372093023256,1.1025641025641
22,"Zeus",49,"Dragon Knight",31,17,48,0.645833333333333,0.615384615384615
22,"Zeus",50,"Dazzle",147,119,266,0.552631578947368,3.41025641025641
22,"Zeus",51,"Clockwerk",81,80,161,0.503105590062112,2.06410256410256
22,"Zeus",52,"Leshrac",23,16,39,0.58974358974359,0.5
22,"Zeus",53,"Nature's Prophet",75,76,151,0.496688741721854,1.93589743589744
22,"Zeus",54,"Lifestealer",47,37,84,0.55952380952381,1.07692307692308
22,"Zeus",55,"Dark Seer",67,47,114,0.587719298245614,1.46153846153846
22,"Zeus",56,"Clinkz",44,32,76,0.578947368421053,0.974358974358974
22,"Zeus",57,"Omniknight",112,51,163,0.687116564417178,2.08974358974359
22,"Zeus",58,"Enchantress",8,12,20,0.4,0.256410256410256
22,"Zeus",59,"Huskar",45,63,108,0.416666666666667,1.38461538461538
22,"Zeus",60,"Night Stalker",64,37,101,0.633663366336634,1.29487179487179
22,"Zeus",61,"Broodmother",23,26,49,0.469387755102041,0.628205128205128
22,"Zeus",62,"Bounty Hunter",104,88,192,0.541666666666667,2.46153846153846
22,"Zeus",63,"Weaver",47,43,90,0.522222222222222,1.15384615384615
22,"Zeus",64,"Jakiro",45,27,72,0.625,0.923076923076923
22,"Zeus",65,"Batrider",17,16,33,0.515151515151515,0.423076923076923
22,"Zeus",66,"Chen",11,3,14,0.785714285714286,0.179487179487179
22,"Zeus",67,"Spectre",239,136,375,0.637333333333333,4.80769230769231
22,"Zeus",68,"Ancient Apparition",139,98,237,0.586497890295359,3.03846153846154
22,"Zeus",69,"Doom",159,114,273,0.582417582417582,3.5
22,"Zeus",70,"Ursa",99,51,150,0.66,1.92307692307692
22,"Zeus",71,"Spirit Breaker",166,108,274,0.605839416058394,3.51282051282051
22,"Zeus",72,"Gyrocopter",101,90,191,0.528795811518325,2.44871794871795
22,"Zeus",73,"Alchemist",151,124,275,0.549090909090909,3.52564102564103
22,"Zeus",74,"Invoker",122,102,224,0.544642857142857,2.87179487179487
22,"Zeus",75,"Silencer",95,87,182,0.521978021978022,2.33333333333333
22,"Zeus",76,"Outworld Devourer",27,20,47,0.574468085106383,0.602564102564103
22,"Zeus",77,"Lycan",19,14,33,0.575757575757576,0.423076923076923
22,"Zeus",78,"Brewmaster",12,12,24,0.5,0.307692307692308
22,"Zeus",79,"Shadow Demon",19,19,38,0.5,0.487179487179487
22,"Zeus",80,"Lone Druid",13,17,30,0.433333333333333,0.384615384615385
22,"Zeus",81,"Chaos Knight",62,48,110,0.563636363636364,1.41025641025641
22,"Zeus",82,"Meepo",35,24,59,0.593220338983051,0.756410256410256
22,"Zeus",83,"Treant Protector",32,30,62,0.516129032258065,0.794871794871795
22,"Zeus",84,"Ogre Magi",89,60,149,0.597315436241611,1.91025641025641
22,"Zeus",85,"Undying",114,80,194,0.587628865979381,2.48717948717949
22,"Zeus",86,"Rubick",107,114,221,0.484162895927602,2.83333333333333
22,"Zeus",87,"Disruptor",78,59,137,0.569343065693431,1.75641025641026
22,"Zeus",88,"Nyx Assassin",46,43,89,0.51685393258427,1.14102564102564
22,"Zeus",89,"Naga Siren",20,13,33,0.606060606060606,0.423076923076923
22,"Zeus",90,"Keeper of the Light",44,33,77,0.571428571428571,0.987179487179487
22,"Zeus",91,"Io",21,16,37,0.567567567567568,0.474358974358974
22,"Zeus",92,"Visage",12,17,29,0.413793103448276,0.371794871794872
22,"Zeus",93,"Slark",167,130,297,0.562289562289562,3.80769230769231
22,"Zeus",94,"Medusa",51,42,93,0.548387096774194,1.19230769230769
22,"Zeus",95,"Troll Warlord",34,28,62,0.548387096774194,0.794871794871795
22,"Zeus",96,"Centaur Warrunner",46,27,73,0.63013698630137,0.935897435897436
22,"Zeus",97,"Magnus",39,42,81,0.481481481481481,1.03846153846154
22,"Zeus",98,"Timbersaw",63,44,107,0.588785046728972,1.37179487179487
22,"Zeus",99,"Bristleback",93,74,167,0.55688622754491,2.14102564102564
22,"Zeus",100,"Tusk",166,156,322,0.515527950310559,4.12820512820513
22,"Zeus",101,"Skywrath Mage",46,44,90,0.511111111111111,1.15384615384615
22,"Zeus",102,"Abaddon",72,26,98,0.73469387755102,1.25641025641026
22,"Zeus",103,"Elder Titan",16,9,25,0.64,0.320512820512821
22,"Zeus",104,"Legion Commander",192,140,332,0.578313253012048,4.25641025641026
22,"Zeus",105,"Techies",25,27,52,0.480769230769231,0.666666666666667
22,"Zeus",106,"Ember Spirit",95,96,191,0.49738219895288,2.44871794871795
22,"Zeus",107,"Earth Spirit",42,39,81,0.518518518518518,1.03846153846154
22,"Zeus",109,"Terrorblade",29,16,45,0.644444444444444,0.576923076923077
22,"Zeus",110,"Phoenix",46,34,80,0.575,1.02564102564103
22,"Zeus",111,"Oracle",24,9,33,0.727272727272727,0.423076923076923
22,"Zeus",112,"Winter Wyvern",135,89,224,0.602678571428571,2.87179487179487
23,"Kunkka",25,"Lina",61,92,153,0.398692810457516,1.96153846153846
23,"Kunkka",26,"Lion",61,83,144,0.423611111111111,1.84615384615385
23,"Kunkka",27,"Shadow Shaman",34,34,68,0.5,0.871794871794872
23,"Kunkka",28,"Slardar",73,72,145,0.503448275862069,1.85897435897436
23,"Kunkka",29,"Tidehunter",26,25,51,0.509803921568627,0.653846153846154
23,"Kunkka",30,"Witch Doctor",66,80,146,0.452054794520548,1.87179487179487
23,"Kunkka",31,"Lich",39,45,84,0.464285714285714,1.07692307692308
23,"Kunkka",32,"Riki",36,42,78,0.461538461538462,1
23,"Kunkka",33,"Enigma",26,32,58,0.448275862068966,0.743589743589744
23,"Kunkka",34,"Tinker",16,17,33,0.484848484848485,0.423076923076923
23,"Kunkka",35,"Sniper",33,36,69,0.478260869565217,0.884615384615385
23,"Kunkka",36,"Necrophos",61,48,109,0.559633027522936,1.3974358974359
23,"Kunkka",37,"Warlock",19,22,41,0.463414634146341,0.525641025641026
23,"Kunkka",38,"Beastmaster",5,16,21,0.238095238095238,0.269230769230769
23,"Kunkka",39,"Queen of Pain",72,111,183,0.39344262295082,2.34615384615385
23,"Kunkka",40,"Venomancer",32,37,69,0.463768115942029,0.884615384615385
23,"Kunkka",41,"Faceless Void",27,42,69,0.391304347826087,0.884615384615385
23,"Kunkka",42,"Wraith King",70,44,114,0.614035087719298,1.46153846153846
23,"Kunkka",43,"Death Prophet",17,25,42,0.404761904761905,0.538461538461538
23,"Kunkka",44,"Phantom Assassin",51,86,137,0.372262773722628,1.75641025641026
23,"Kunkka",45,"Pugna",22,19,41,0.536585365853659,0.525641025641026
23,"Kunkka",46,"Templar Assassin",49,55,104,0.471153846153846,1.33333333333333
23,"Kunkka",47,"Viper",20,20,40,0.5,0.512820512820513
23,"Kunkka",48,"Luna",11,21,32,0.34375,0.41025641025641
23,"Kunkka",49,"Dragon Knight",15,17,32,0.46875,0.41025641025641
23,"Kunkka",50,"Dazzle",67,77,144,0.465277777777778,1.84615384615385
23,"Kunkka",51,"Clockwerk",32,37,69,0.463768115942029,0.884615384615385
23,"Kunkka",52,"Leshrac",12,13,25,0.48,0.320512820512821
23,"Kunkka",53,"Nature's Prophet",26,37,63,0.412698412698413,0.807692307692308
23,"Kunkka",54,"Lifestealer",25,29,54,0.462962962962963,0.692307692307692
23,"Kunkka",55,"Dark Seer",39,43,82,0.475609756097561,1.05128205128205
23,"Kunkka",56,"Clinkz",15,27,42,0.357142857142857,0.538461538461538
23,"Kunkka",57,"Omniknight",52,37,89,0.584269662921348,1.14102564102564
23,"Kunkka",58,"Enchantress",12,8,20,0.6,0.256410256410256
23,"Kunkka",59,"Huskar",27,29,56,0.482142857142857,0.717948717948718
23,"Kunkka",60,"Night Stalker",19,22,41,0.463414634146341,0.525641025641026
23,"Kunkka",61,"Broodmother",8,17,25,0.32,0.320512820512821
23,"Kunkka",62,"Bounty Hunter",50,55,105,0.476190476190476,1.34615384615385
23,"Kunkka",63,"Weaver",25,31,56,0.446428571428571,0.717948717948718
23,"Kunkka",64,"Jakiro",21,30,51,0.411764705882353,0.653846153846154
23,"Kunkka",65,"Batrider",1,12,13,0.0769230769230769,0.166666666666667
23,"Kunkka",66,"Chen",4,3,7,0.571428571428571,0.0897435897435897
23,"Kunkka",67,"Spectre",68,58,126,0.53968253968254,1.61538461538462
23,"Kunkka",68,"Ancient Apparition",43,65,108,0.398148148148148,1.38461538461538
23,"Kunkka",69,"Doom",64,79,143,0.447552447552448,1.83333333333333
23,"Kunkka",70,"Ursa",41,32,73,0.561643835616438,0.935897435897436
23,"Kunkka",71,"Spirit Breaker",50,61,111,0.45045045045045,1.42307692307692
23,"Kunkka",72,"Gyrocopter",54,58,112,0.482142857142857,1.43589743589744
23,"Kunkka",73,"Alchemist",78,76,154,0.506493506493506,1.97435897435897
23,"Kunkka",74,"Invoker",78,113,191,0.408376963350785,2.44871794871795
23,"Kunkka",75,"Silencer",76,59,135,0.562962962962963,1.73076923076923
23,"Kunkka",76,"Outworld Devourer",9,18,27,0.333333333333333,0.346153846153846
23,"Kunkka",77,"Lycan",7,8,15,0.466666666666667,0.192307692307692
23,"Kunkka",78,"Brewmaster",7,9,16,0.4375,0.205128205128205
23,"Kunkka",79,"Shadow Demon",24,18,42,0.571428571428571,0.538461538461538
23,"Kunkka",80,"Lone Druid",7,9,16,0.4375,0.205128205128205
23,"Kunkka",81,"Chaos Knight",19,26,45,0.422222222222222,0.576923076923077
23,"Kunkka",82,"Meepo",18,18,36,0.5,0.461538461538462
23,"Kunkka",83,"Treant Protector",17,22,39,0.435897435897436,0.5
23,"Kunkka",84,"Ogre Magi",41,31,72,0.569444444444444,0.923076923076923
23,"Kunkka",85,"Undying",44,50,94,0.468085106382979,1.20512820512821
23,"Kunkka",86,"Rubick",69,98,167,0.413173652694611,2.14102564102564
23,"Kunkka",87,"Disruptor",33,50,83,0.397590361445783,1.06410256410256
23,"Kunkka",88,"Nyx Assassin",22,21,43,0.511627906976744,0.551282051282051
23,"Kunkka",89,"Naga Siren",6,17,23,0.260869565217391,0.294871794871795
23,"Kunkka",90,"Keeper of the Light",14,21,35,0.4,0.448717948717949
23,"Kunkka",91,"Io",12,14,26,0.461538461538462,0.333333333333333
23,"Kunkka",92,"Visage",7,6,13,0.538461538461538,0.166666666666667
23,"Kunkka",93,"Slark",81,80,161,0.503105590062112,2.06410256410256
23,"Kunkka",94,"Medusa",16,25,41,0.390243902439024,0.525641025641026
23,"Kunkka",95,"Troll Warlord",9,25,34,0.264705882352941,0.435897435897436
23,"Kunkka",96,"Centaur Warrunner",15,17,32,0.46875,0.41025641025641
23,"Kunkka",97,"Magnus",35,36,71,0.492957746478873,0.91025641025641
23,"Kunkka",98,"Timbersaw",21,28,49,0.428571428571429,0.628205128205128
23,"Kunkka",99,"Bristleback",28,43,71,0.394366197183099,0.91025641025641
23,"Kunkka",100,"Tusk",65,76,141,0.460992907801418,1.80769230769231
23,"Kunkka",101,"Skywrath Mage",14,30,44,0.318181818181818,0.564102564102564
23,"Kunkka",102,"Abaddon",34,28,62,0.548387096774194,0.794871794871795
23,"Kunkka",103,"Elder Titan",11,12,23,0.478260869565217,0.294871794871795
23,"Kunkka",104,"Legion Commander",67,110,177,0.378531073446328,2.26923076923077
23,"Kunkka",105,"Techies",4,14,18,0.222222222222222,0.230769230769231
23,"Kunkka",106,"Ember Spirit",41,54,95,0.431578947368421,1.21794871794872
23,"Kunkka",107,"Earth Spirit",21,26,47,0.446808510638298,0.602564102564103
23,"Kunkka",109,"Terrorblade",14,20,34,0.411764705882353,0.435897435897436
23,"Kunkka",110,"Phoenix",19,27,46,0.41304347826087,0.58974358974359
23,"Kunkka",111,"Oracle",5,10,15,0.333333333333333,0.192307692307692
23,"Kunkka",112,"Winter Wyvern",64,67,131,0.488549618320611,1.67948717948718
25,"Lina",26,"Lion",149,234,383,0.389033942558747,4.91025641025641
25,"Lina",27,"Shadow Shaman",77,84,161,0.478260869565217,2.06410256410256
25,"Lina",28,"Slardar",358,398,756,0.473544973544974,9.69230769230769
25,"Lina",29,"Tidehunter",63,76,139,0.453237410071942,1.78205128205128
25,"Lina",30,"Witch Doctor",168,208,376,0.446808510638298,4.82051282051282
25,"Lina",31,"Lich",101,120,221,0.457013574660633,2.83333333333333
25,"Lina",32,"Riki",128,132,260,0.492307692307692,3.33333333333333
25,"Lina",33,"Enigma",74,74,148,0.5,1.8974358974359
25,"Lina",34,"Tinker",48,68,116,0.413793103448276,1.48717948717949
25,"Lina",35,"Sniper",59,111,170,0.347058823529412,2.17948717948718
25,"Lina",36,"Necrophos",147,173,320,0.459375,4.1025641025641
25,"Lina",37,"Warlock",49,52,101,0.485148514851485,1.29487179487179
25,"Lina",38,"Beastmaster",28,44,72,0.388888888888889,0.923076923076923
25,"Lina",39,"Queen of Pain",163,294,457,0.356673960612691,5.85897435897436
25,"Lina",40,"Venomancer",73,85,158,0.462025316455696,2.02564102564103
25,"Lina",41,"Faceless Void",75,142,217,0.345622119815668,2.78205128205128
25,"Lina",42,"Wraith King",280,254,534,0.524344569288389,6.84615384615385
25,"Lina",43,"Death Prophet",25,42,67,0.373134328358209,0.858974358974359
25,"Lina",44,"Phantom Assassin",197,273,470,0.419148936170213,6.02564102564103
25,"Lina",45,"Pugna",24,49,73,0.328767123287671,0.935897435897436
25,"Lina",46,"Templar Assassin",104,133,237,0.438818565400844,3.03846153846154
25,"Lina",47,"Viper",81,112,193,0.419689119170984,2.47435897435897
25,"Lina",48,"Luna",71,71,142,0.5,1.82051282051282
25,"Lina",49,"Dragon Knight",48,60,108,0.444444444444444,1.38461538461538
25,"Lina",50,"Dazzle",202,243,445,0.453932584269663,5.70512820512821
25,"Lina",51,"Clockwerk",111,165,276,0.402173913043478,3.53846153846154
25,"Lina",52,"Leshrac",19,29,48,0.395833333333333,0.615384615384615
25,"Lina",53,"Nature's Prophet",52,121,173,0.300578034682081,2.21794871794872
25,"Lina",54,"Lifestealer",66,116,182,0.362637362637363,2.33333333333333
25,"Lina",55,"Dark Seer",117,151,268,0.436567164179104,3.43589743589744
25,"Lina",56,"Clinkz",64,93,157,0.407643312101911,2.01282051282051
25,"Lina",57,"Omniknight",156,135,291,0.536082474226804,3.73076923076923
25,"Lina",58,"Enchantress",13,41,54,0.240740740740741,0.692307692307692
25,"Lina",59,"Huskar",89,123,212,0.419811320754717,2.71794871794872
25,"Lina",60,"Night Stalker",90,98,188,0.478723404255319,2.41025641025641
25,"Lina",61,"Broodmother",27,51,78,0.346153846153846,1
25,"Lina",62,"Bounty Hunter",169,232,401,0.4214463840399,5.14102564102564
25,"Lina",63,"Weaver",70,102,172,0.406976744186047,2.20512820512821
25,"Lina",64,"Jakiro",66,74,140,0.471428571428571,1.79487179487179
25,"Lina",65,"Batrider",18,38,56,0.321428571428571,0.717948717948718
25,"Lina",66,"Chen",10,21,31,0.32258064516129,0.397435897435897
25,"Lina",67,"Spectre",219,219,438,0.5,5.61538461538461
25,"Lina",68,"Ancient Apparition",165,208,373,0.442359249329759,4.78205128205128
25,"Lina",69,"Doom",249,272,521,0.477927063339731,6.67948717948718
25,"Lina",70,"Ursa",129,149,278,0.464028776978417,3.56410256410256
25,"Lina",71,"Spirit Breaker",228,245,473,0.482029598308668,6.06410256410256
25,"Lina",72,"Gyrocopter",148,270,418,0.354066985645933,5.35897435897436
25,"Lina",73,"Alchemist",228,295,523,0.435946462715105,6.70512820512821
25,"Lina",74,"Invoker",211,276,487,0.433264887063655,6.24358974358974
25,"Lina",75,"Silencer",164,199,363,0.451790633608815,4.65384615384615
25,"Lina",76,"Outworld Devourer",33,61,94,0.351063829787234,1.20512820512821
25,"Lina",77,"Lycan",25,36,61,0.409836065573771,0.782051282051282
25,"Lina",78,"Brewmaster",21,32,53,0.39622641509434,0.67948717948718
25,"Lina",79,"Shadow Demon",43,73,116,0.370689655172414,1.48717948717949
25,"Lina",80,"Lone Druid",34,37,71,0.47887323943662,0.91025641025641
25,"Lina",81,"Chaos Knight",80,96,176,0.454545454545455,2.25641025641026
25,"Lina",82,"Meepo",42,59,101,0.415841584158416,1.29487179487179
25,"Lina",83,"Treant Protector",43,66,109,0.394495412844037,1.3974358974359
25,"Lina",84,"Ogre Magi",108,153,261,0.413793103448276,3.34615384615385
25,"Lina",85,"Undying",184,165,349,0.527220630372493,4.47435897435897
25,"Lina",86,"Rubick",175,251,426,0.410798122065728,5.46153846153846
25,"Lina",87,"Disruptor",107,131,238,0.449579831932773,3.05128205128205
25,"Lina",88,"Nyx Assassin",63,90,153,0.411764705882353,1.96153846153846
25,"Lina",89,"Naga Siren",16,35,51,0.313725490196078,0.653846153846154
25,"Lina",90,"Keeper of the Light",39,73,112,0.348214285714286,1.43589743589744
25,"Lina",91,"Io",32,53,85,0.376470588235294,1.08974358974359
25,"Lina",92,"Visage",20,37,57,0.350877192982456,0.730769230769231
25,"Lina",93,"Slark",218,347,565,0.385840707964602,7.24358974358974
25,"Lina",94,"Medusa",74,84,158,0.468354430379747,2.02564102564103
25,"Lina",95,"Troll Warlord",51,65,116,0.439655172413793,1.48717948717949
25,"Lina",96,"Centaur Warrunner",52,62,114,0.456140350877193,1.46153846153846
25,"Lina",97,"Magnus",70,103,173,0.404624277456647,2.21794871794872
25,"Lina",98,"Timbersaw",69,114,183,0.377049180327869,2.34615384615385
25,"Lina",99,"Bristleback",123,160,283,0.434628975265018,3.62820512820513
25,"Lina",100,"Tusk",294,387,681,0.431718061674009,8.73076923076923
25,"Lina",101,"Skywrath Mage",50,93,143,0.34965034965035,1.83333333333333
25,"Lina",102,"Abaddon",105,97,202,0.51980198019802,2.58974358974359
25,"Lina",103,"Elder Titan",17,33,50,0.34,0.641025641025641
25,"Lina",104,"Legion Commander",230,347,577,0.398613518197574,7.3974358974359
25,"Lina",105,"Techies",19,40,59,0.322033898305085,0.756410256410256
25,"Lina",106,"Ember Spirit",164,247,411,0.399026763990268,5.26923076923077
25,"Lina",107,"Earth Spirit",94,94,188,0.5,2.41025641025641
25,"Lina",109,"Terrorblade",53,63,116,0.456896551724138,1.48717948717949
25,"Lina",110,"Phoenix",61,97,158,0.386075949367089,2.02564102564103
25,"Lina",111,"Oracle",17,37,54,0.314814814814815,0.692307692307692
25,"Lina",112,"Winter Wyvern",163,235,398,0.409547738693467,5.1025641025641
26,"Lion",27,"Shadow Shaman",45,38,83,0.542168674698795,1.06410256410256
26,"Lion",28,"Slardar",351,300,651,0.539170506912442,8.34615384615385
26,"Lion",29,"Tidehunter",73,58,131,0.557251908396947,1.67948717948718
26,"Lion",30,"Witch Doctor",96,85,181,0.530386740331492,2.32051282051282
26,"Lion",31,"Lich",86,90,176,0.488636363636364,2.25641025641026
26,"Lion",32,"Riki",124,106,230,0.539130434782609,2.94871794871795
26,"Lion",33,"Enigma",33,59,92,0.358695652173913,1.17948717948718
26,"Lion",34,"Tinker",68,103,171,0.39766081871345,2.19230769230769
26,"Lion",35,"Sniper",90,111,201,0.447761194029851,2.57692307692308
26,"Lion",36,"Necrophos",140,126,266,0.526315789473684,3.41025641025641
26,"Lion",37,"Warlock",32,32,64,0.5,0.82051282051282
26,"Lion",38,"Beastmaster",42,28,70,0.6,0.897435897435897
26,"Lion",39,"Queen of Pain",258,376,634,0.406940063091483,8.12820512820513
26,"Lion",40,"Venomancer",56,55,111,0.504504504504504,1.42307692307692
26,"Lion",41,"Faceless Void",84,115,199,0.422110552763819,2.55128205128205
26,"Lion",42,"Wraith King",235,205,440,0.534090909090909,5.64102564102564
26,"Lion",43,"Death Prophet",28,55,83,0.337349397590361,1.06410256410256
26,"Lion",44,"Phantom Assassin",184,260,444,0.414414414414414,5.69230769230769
26,"Lion",45,"Pugna",35,34,69,0.507246376811594,0.884615384615385
26,"Lion",46,"Templar Assassin",181,198,379,0.477572559366755,4.85897435897436
26,"Lion",47,"Viper",91,109,200,0.455,2.56410256410256
26,"Lion",48,"Luna",65,79,144,0.451388888888889,1.84615384615385
26,"Lion",49,"Dragon Knight",50,78,128,0.390625,1.64102564102564
26,"Lion",50,"Dazzle",114,139,253,0.450592885375494,3.24358974358974
26,"Lion",51,"Clockwerk",142,121,263,0.539923954372624,3.37179487179487
26,"Lion",52,"Leshrac",24,37,61,0.39344262295082,0.782051282051282
26,"Lion",53,"Nature's Prophet",49,103,152,0.322368421052632,1.94871794871795
26,"Lion",54,"Lifestealer",47,94,141,0.333333333333333,1.80769230769231
26,"Lion",55,"Dark Seer",96,122,218,0.440366972477064,2.79487179487179
26,"Lion",56,"Clinkz",50,78,128,0.390625,1.64102564102564
26,"Lion",57,"Omniknight",111,89,200,0.555,2.56410256410256
26,"Lion",58,"Enchantress",19,31,50,0.38,0.641025641025641
26,"Lion",59,"Huskar",91,107,198,0.45959595959596,2.53846153846154
26,"Lion",60,"Night Stalker",87,80,167,0.520958083832335,2.14102564102564
26,"Lion",61,"Broodmother",35,45,80,0.4375,1.02564102564103
26,"Lion",62,"Bounty Hunter",148,155,303,0.488448844884488,3.88461538461538
26,"Lion",63,"Weaver",61,80,141,0.432624113475177,1.80769230769231
26,"Lion",64,"Jakiro",28,42,70,0.4,0.897435897435897
26,"Lion",65,"Batrider",21,30,51,0.411764705882353,0.653846153846154
26,"Lion",66,"Chen",11,18,29,0.379310344827586,0.371794871794872
26,"Lion",67,"Spectre",246,185,431,0.5707656612529,5.52564102564103
26,"Lion",68,"Ancient Apparition",106,120,226,0.469026548672566,2.8974358974359
26,"Lion",69,"Doom",223,258,481,0.463617463617464,6.16666666666667
26,"Lion",70,"Ursa",143,134,277,0.516245487364621,3.55128205128205
26,"Lion",71,"Spirit Breaker",179,184,363,0.493112947658402,4.65384615384615
26,"Lion",72,"Gyrocopter",167,222,389,0.429305912596401,4.98717948717949
26,"Lion",73,"Alchemist",305,302,607,0.502471169686985,7.78205128205128
26,"Lion",74,"Invoker",317,355,672,0.47172619047619,8.61538461538461
26,"Lion",75,"Silencer",152,140,292,0.520547945205479,3.74358974358974
26,"Lion",76,"Outworld Devourer",48,38,86,0.558139534883721,1.1025641025641
26,"Lion",77,"Lycan",34,29,63,0.53968253968254,0.807692307692308
26,"Lion",78,"Brewmaster",25,29,54,0.462962962962963,0.692307692307692
26,"Lion",79,"Shadow Demon",13,16,29,0.448275862068966,0.371794871794872
26,"Lion",80,"Lone Druid",23,32,55,0.418181818181818,0.705128205128205
26,"Lion",81,"Chaos Knight",49,73,122,0.401639344262295,1.56410256410256
26,"Lion",82,"Meepo",41,59,100,0.41,1.28205128205128
26,"Lion",83,"Treant Protector",25,36,61,0.409836065573771,0.782051282051282
26,"Lion",84,"Ogre Magi",74,84,158,0.468354430379747,2.02564102564103
26,"Lion",85,"Undying",164,125,289,0.567474048442907,3.70512820512821
26,"Lion",86,"Rubick",96,133,229,0.419213973799127,2.93589743589744
26,"Lion",87,"Disruptor",60,59,119,0.504201680672269,1.52564102564103
26,"Lion",88,"Nyx Assassin",52,79,131,0.396946564885496,1.67948717948718
26,"Lion",89,"Naga Siren",21,31,52,0.403846153846154,0.666666666666667
26,"Lion",90,"Keeper of the Light",22,39,61,0.360655737704918,0.782051282051282
26,"Lion",91,"Io",34,41,75,0.453333333333333,0.961538461538462
26,"Lion",92,"Visage",17,17,34,0.5,0.435897435897436
26,"Lion",93,"Slark",250,284,534,0.468164794007491,6.84615384615385
26,"Lion",94,"Medusa",73,74,147,0.496598639455782,1.88461538461538
26,"Lion",95,"Troll Warlord",51,57,108,0.472222222222222,1.38461538461538
26,"Lion",96,"Centaur Warrunner",52,52,104,0.5,1.33333333333333
26,"Lion",97,"Magnus",82,131,213,0.384976525821596,2.73076923076923
26,"Lion",98,"Timbersaw",75,123,198,0.378787878787879,2.53846153846154
26,"Lion",99,"Bristleback",120,140,260,0.461538461538462,3.33333333333333
26,"Lion",100,"Tusk",271,287,558,0.485663082437276,7.15384615384615
26,"Lion",101,"Skywrath Mage",36,55,91,0.395604395604396,1.16666666666667
26,"Lion",102,"Abaddon",78,74,152,0.513157894736842,1.94871794871795
26,"Lion",103,"Elder Titan",19,18,37,0.513513513513513,0.474358974358974
26,"Lion",104,"Legion Commander",212,286,498,0.42570281124498,6.38461538461539
26,"Lion",105,"Techies",15,33,48,0.3125,0.615384615384615
26,"Lion",106,"Ember Spirit",212,260,472,0.449152542372881,6.05128205128205
26,"Lion",107,"Earth Spirit",76,70,146,0.520547945205479,1.87179487179487
26,"Lion",109,"Terrorblade",54,49,103,0.524271844660194,1.32051282051282
26,"Lion",110,"Phoenix",78,89,167,0.467065868263473,2.14102564102564
26,"Lion",111,"Oracle",15,21,36,0.416666666666667,0.461538461538462
26,"Lion",112,"Winter Wyvern",107,120,227,0.47136563876652,2.91025641025641
27,"Shadow Shaman",28,"Slardar",186,113,299,0.622073578595318,3.83333333333333
27,"Shadow Shaman",29,"Tidehunter",31,39,70,0.442857142857143,0.897435897435897
27,"Shadow Shaman",30,"Witch Doctor",60,49,109,0.55045871559633,1.3974358974359
27,"Shadow Shaman",31,"Lich",34,21,55,0.618181818181818,0.705128205128205
27,"Shadow Shaman",32,"Riki",69,38,107,0.644859813084112,1.37179487179487
27,"Shadow Shaman",33,"Enigma",21,17,38,0.552631578947368,0.487179487179487
27,"Shadow Shaman",34,"Tinker",28,31,59,0.474576271186441,0.756410256410256
27,"Shadow Shaman",35,"Sniper",51,47,98,0.520408163265306,1.25641025641026
27,"Shadow Shaman",36,"Necrophos",100,52,152,0.657894736842105,1.94871794871795
27,"Shadow Shaman",37,"Warlock",19,14,33,0.575757575757576,0.423076923076923
27,"Shadow Shaman",38,"Beastmaster",15,17,32,0.46875,0.41025641025641
27,"Shadow Shaman",39,"Queen of Pain",112,151,263,0.425855513307985,3.37179487179487
27,"Shadow Shaman",40,"Venomancer",22,29,51,0.431372549019608,0.653846153846154
27,"Shadow Shaman",41,"Faceless Void",35,52,87,0.402298850574713,1.11538461538462
27,"Shadow Shaman",42,"Wraith King",136,84,220,0.618181818181818,2.82051282051282
27,"Shadow Shaman",43,"Death Prophet",40,38,78,0.512820512820513,1
27,"Shadow Shaman",44,"Phantom Assassin",100,102,202,0.495049504950495,2.58974358974359
27,"Shadow Shaman",45,"Pugna",19,15,34,0.558823529411765,0.435897435897436
27,"Shadow Shaman",46,"Templar Assassin",86,74,160,0.5375,2.05128205128205
27,"Shadow Shaman",47,"Viper",58,61,119,0.487394957983193,1.52564102564103
27,"Shadow Shaman",48,"Luna",44,34,78,0.564102564102564,1
27,"Shadow Shaman",49,"Dragon Knight",30,32,62,0.483870967741935,0.794871794871795
27,"Shadow Shaman",50,"Dazzle",57,53,110,0.518181818181818,1.41025641025641
27,"Shadow Shaman",51,"Clockwerk",46,66,112,0.410714285714286,1.43589743589744
27,"Shadow Shaman",52,"Leshrac",14,16,30,0.466666666666667,0.384615384615385
27,"Shadow Shaman",53,"Nature's Prophet",35,46,81,0.432098765432099,1.03846153846154
27,"Shadow Shaman",54,"Lifestealer",34,35,69,0.492753623188406,0.884615384615385
27,"Shadow Shaman",55,"Dark Seer",53,40,93,0.56989247311828,1.19230769230769
27,"Shadow Shaman",56,"Clinkz",38,33,71,0.535211267605634,0.91025641025641
27,"Shadow Shaman",57,"Omniknight",63,30,93,0.67741935483871,1.19230769230769
27,"Shadow Shaman",58,"Enchantress",9,8,17,0.529411764705882,0.217948717948718
27,"Shadow Shaman",59,"Huskar",49,50,99,0.494949494949495,1.26923076923077
27,"Shadow Shaman",60,"Night Stalker",45,39,84,0.535714285714286,1.07692307692308
27,"Shadow Shaman",61,"Broodmother",24,18,42,0.571428571428571,0.538461538461538
27,"Shadow Shaman",62,"Bounty Hunter",70,69,139,0.503597122302158,1.78205128205128
27,"Shadow Shaman",63,"Weaver",37,52,89,0.415730337078652,1.14102564102564
27,"Shadow Shaman",64,"Jakiro",30,21,51,0.588235294117647,0.653846153846154
27,"Shadow Shaman",65,"Batrider",15,11,26,0.576923076923077,0.333333333333333
27,"Shadow Shaman",66,"Chen",6,4,10,0.6,0.128205128205128
27,"Shadow Shaman",67,"Spectre",115,86,201,0.572139303482587,2.57692307692308
27,"Shadow Shaman",68,"Ancient Apparition",52,44,96,0.541666666666667,1.23076923076923
27,"Shadow Shaman",69,"Doom",104,65,169,0.615384615384615,2.16666666666667
27,"Shadow Shaman",70,"Ursa",122,82,204,0.598039215686274,2.61538461538462
27,"Shadow Shaman",71,"Spirit Breaker",116,84,200,0.58,2.56410256410256
27,"Shadow Shaman",72,"Gyrocopter",118,102,220,0.536363636363636,2.82051282051282
27,"Shadow Shaman",73,"Alchemist",156,132,288,0.541666666666667,3.69230769230769
27,"Shadow Shaman",74,"Invoker",168,177,345,0.48695652173913,4.42307692307692
27,"Shadow Shaman",75,"Silencer",74,54,128,0.578125,1.64102564102564
27,"Shadow Shaman",76,"Outworld Devourer",23,20,43,0.534883720930233,0.551282051282051
27,"Shadow Shaman",77,"Lycan",26,12,38,0.684210526315789,0.487179487179487
27,"Shadow Shaman",78,"Brewmaster",13,17,30,0.433333333333333,0.384615384615385
27,"Shadow Shaman",79,"Shadow Demon",8,16,24,0.333333333333333,0.307692307692308
27,"Shadow Shaman",80,"Lone Druid",18,5,23,0.782608695652174,0.294871794871795
27,"Shadow Shaman",81,"Chaos Knight",29,29,58,0.5,0.743589743589744
27,"Shadow Shaman",82,"Meepo",20,22,42,0.476190476190476,0.538461538461538
27,"Shadow Shaman",83,"Treant Protector",21,22,43,0.488372093023256,0.551282051282051
27,"Shadow Shaman",84,"Ogre Magi",40,36,76,0.526315789473684,0.974358974358974
27,"Shadow Shaman",85,"Undying",79,67,146,0.541095890410959,1.87179487179487
27,"Shadow Shaman",86,"Rubick",50,52,102,0.490196078431373,1.30769230769231
27,"Shadow Shaman",87,"Disruptor",35,28,63,0.555555555555556,0.807692307692308
27,"Shadow Shaman",88,"Nyx Assassin",28,32,60,0.466666666666667,0.769230769230769
27,"Shadow Shaman",89,"Naga Siren",16,15,31,0.516129032258065,0.397435897435897
27,"Shadow Shaman",90,"Keeper of the Light",19,17,36,0.527777777777778,0.461538461538462
27,"Shadow Shaman",91,"Io",13,8,21,0.619047619047619,0.269230769230769
27,"Shadow Shaman",92,"Visage",14,14,28,0.5,0.358974358974359
27,"Shadow Shaman",93,"Slark",129,122,251,0.51394422310757,3.21794871794872
27,"Shadow Shaman",94,"Medusa",39,28,67,0.582089552238806,0.858974358974359
27,"Shadow Shaman",95,"Troll Warlord",27,26,53,0.509433962264151,0.67948717948718
27,"Shadow Shaman",96,"Centaur Warrunner",49,20,69,0.710144927536232,0.884615384615385
27,"Shadow Shaman",97,"Magnus",52,37,89,0.584269662921348,1.14102564102564
27,"Shadow Shaman",98,"Timbersaw",41,38,79,0.518987341772152,1.01282051282051
27,"Shadow Shaman",99,"Bristleback",69,55,124,0.556451612903226,1.58974358974359
27,"Shadow Shaman",100,"Tusk",165,121,286,0.576923076923077,3.66666666666667
27,"Shadow Shaman",101,"Skywrath Mage",25,26,51,0.490196078431373,0.653846153846154
27,"Shadow Shaman",102,"Abaddon",59,35,94,0.627659574468085,1.20512820512821
27,"Shadow Shaman",103,"Elder Titan",11,10,21,0.523809523809524,0.269230769230769
27,"Shadow Shaman",104,"Legion Commander",101,125,226,0.446902654867257,2.8974358974359
27,"Shadow Shaman",105,"Techies",9,14,23,0.391304347826087,0.294871794871795
27,"Shadow Shaman",106,"Ember Spirit",119,103,222,0.536036036036036,2.84615384615385
27,"Shadow Shaman",107,"Earth Spirit",33,18,51,0.647058823529412,0.653846153846154
27,"Shadow Shaman",109,"Terrorblade",21,35,56,0.375,0.717948717948718
27,"Shadow Shaman",110,"Phoenix",54,34,88,0.613636363636364,1.12820512820513
27,"Shadow Shaman",111,"Oracle",8,7,15,0.533333333333333,0.192307692307692
27,"Shadow Shaman",112,"Winter Wyvern",63,46,109,0.577981651376147,1.3974358974359
28,"Slardar",29,"Tidehunter",55,33,88,0.625,1.12820512820513
28,"Slardar",30,"Witch Doctor",383,280,663,0.577677224736048,8.5
28,"Slardar",31,"Lich",331,174,505,0.655445544554455,6.47435897435897
28,"Slardar",32,"Riki",178,108,286,0.622377622377622,3.66666666666667
28,"Slardar",33,"Enigma",114,91,205,0.55609756097561,2.62820512820513
28,"Slardar",34,"Tinker",99,121,220,0.45,2.82051282051282
28,"Slardar",35,"Sniper",116,128,244,0.475409836065574,3.12820512820513
28,"Slardar",36,"Necrophos",255,149,404,0.631188118811881,5.17948717948718
28,"Slardar",37,"Warlock",89,53,142,0.626760563380282,1.82051282051282
28,"Slardar",38,"Beastmaster",33,18,51,0.647058823529412,0.653846153846154
28,"Slardar",39,"Queen of Pain",495,470,965,0.512953367875648,12.3717948717949
28,"Slardar",40,"Venomancer",121,116,237,0.510548523206751,3.03846153846154
28,"Slardar",41,"Faceless Void",79,92,171,0.461988304093567,2.19230769230769
28,"Slardar",42,"Wraith King",346,196,542,0.638376383763838,6.94871794871795
28,"Slardar",43,"Death Prophet",72,50,122,0.590163934426229,1.56410256410256
28,"Slardar",44,"Phantom Assassin",277,221,498,0.556224899598394,6.38461538461539
28,"Slardar",45,"Pugna",53,40,93,0.56989247311828,1.19230769230769
28,"Slardar",46,"Templar Assassin",384,258,642,0.598130841121495,8.23076923076923
28,"Slardar",47,"Viper",141,122,263,0.536121673003802,3.37179487179487
28,"Slardar",48,"Luna",88,77,165,0.533333333333333,2.11538461538462
28,"Slardar",49,"Dragon Knight",44,46,90,0.488888888888889,1.15384615384615
28,"Slardar",50,"Dazzle",615,421,1036,0.593629343629344,13.2820512820513
28,"Slardar",51,"Clockwerk",85,80,165,0.515151515151515,2.11538461538462
28,"Slardar",52,"Leshrac",56,42,98,0.571428571428571,1.25641025641026
28,"Slardar",53,"Nature's Prophet",104,101,205,0.507317073170732,2.62820512820513
28,"Slardar",54,"Lifestealer",75,74,149,0.503355704697987,1.91025641025641
28,"Slardar",55,"Dark Seer",127,98,225,0.564444444444444,2.88461538461538
28,"Slardar",56,"Clinkz",119,108,227,0.524229074889868,2.91025641025641
28,"Slardar",57,"Omniknight",275,167,442,0.622171945701357,5.66666666666667
28,"Slardar",58,"Enchantress",23,29,52,0.442307692307692,0.666666666666667
28,"Slardar",59,"Huskar",174,133,307,0.566775244299674,3.93589743589744
28,"Slardar",60,"Night Stalker",99,93,192,0.515625,2.46153846153846
28,"Slardar",61,"Broodmother",22,51,73,0.301369863013699,0.935897435897436
28,"Slardar",62,"Bounty Hunter",339,250,589,0.575551782682513,7.55128205128205
28,"Slardar",63,"Weaver",81,76,157,0.515923566878981,2.01282051282051
28,"Slardar",64,"Jakiro",143,88,231,0.619047619047619,2.96153846153846
28,"Slardar",65,"Batrider",34,30,64,0.53125,0.82051282051282
28,"Slardar",66,"Chen",34,23,57,0.596491228070175,0.730769230769231
28,"Slardar",67,"Spectre",277,165,442,0.626696832579186,5.66666666666667
28,"Slardar",68,"Ancient Apparition",400,293,693,0.577200577200577,8.88461538461539
28,"Slardar",69,"Doom",239,180,419,0.570405727923628,5.37179487179487
28,"Slardar",70,"Ursa",172,101,273,0.63003663003663,3.5
28,"Slardar",71,"Spirit Breaker",273,205,478,0.571129707112971,6.12820512820513
28,"Slardar",72,"Gyrocopter",317,262,579,0.547495682210708,7.42307692307692
28,"Slardar",73,"Alchemist",532,326,858,0.62004662004662,11
28,"Slardar",74,"Invoker",535,409,944,0.566737288135593,12.1025641025641
28,"Slardar",75,"Silencer",393,280,673,0.583952451708767,8.62820512820513
28,"Slardar",76,"Outworld Devourer",51,40,91,0.56043956043956,1.16666666666667
28,"Slardar",77,"Lycan",36,22,58,0.620689655172414,0.743589743589744
28,"Slardar",78,"Brewmaster",22,22,44,0.5,0.564102564102564
28,"Slardar",79,"Shadow Demon",56,92,148,0.378378378378378,1.8974358974359
28,"Slardar",80,"Lone Druid",26,31,57,0.456140350877193,0.730769230769231
28,"Slardar",81,"Chaos Knight",74,62,136,0.544117647058823,1.74358974358974
28,"Slardar",82,"Meepo",73,61,134,0.544776119402985,1.71794871794872
28,"Slardar",83,"Treant Protector",78,49,127,0.614173228346457,1.62820512820513
28,"Slardar",84,"Ogre Magi",180,157,337,0.534124629080119,4.32051282051282
28,"Slardar",85,"Undying",263,162,425,0.618823529411765,5.44871794871795
28,"Slardar",86,"Rubick",408,370,778,0.524421593830334,9.97435897435897
28,"Slardar",87,"Disruptor",249,180,429,0.58041958041958,5.5
28,"Slardar",88,"Nyx Assassin",80,78,158,0.506329113924051,2.02564102564103
28,"Slardar",89,"Naga Siren",36,46,82,0.439024390243902,1.05128205128205
28,"Slardar",90,"Keeper of the Light",86,89,175,0.491428571428571,2.24358974358974
28,"Slardar",91,"Io",99,80,179,0.553072625698324,2.29487179487179
28,"Slardar",92,"Visage",61,31,92,0.66304347826087,1.17948717948718
28,"Slardar",93,"Slark",332,292,624,0.532051282051282,8
28,"Slardar",94,"Medusa",110,73,183,0.601092896174863,2.34615384615385
28,"Slardar",95,"Troll Warlord",75,56,131,0.572519083969466,1.67948717948718
28,"Slardar",96,"Centaur Warrunner",46,29,75,0.613333333333333,0.961538461538462
28,"Slardar",97,"Magnus",75,76,151,0.496688741721854,1.93589743589744
28,"Slardar",98,"Timbersaw",70,49,119,0.588235294117647,1.52564102564103
28,"Slardar",99,"Bristleback",104,68,172,0.604651162790698,2.20512820512821
28,"Slardar",100,"Tusk",496,380,876,0.5662100456621,11.2307692307692
28,"Slardar",101,"Skywrath Mage",135,141,276,0.489130434782609,3.53846153846154
28,"Slardar",102,"Abaddon",146,92,238,0.613445378151261,3.05128205128205
28,"Slardar",103,"Elder Titan",27,19,46,0.58695652173913,0.58974358974359
28,"Slardar",104,"Legion Commander",287,246,533,0.538461538461538,6.83333333333333
28,"Slardar",105,"Techies",29,34,63,0.46031746031746,0.807692307692308
28,"Slardar",106,"Ember Spirit",387,307,694,0.557636887608069,8.8974358974359
28,"Slardar",107,"Earth Spirit",156,97,253,0.616600790513834,3.24358974358974
28,"Slardar",109,"Terrorblade",61,42,103,0.592233009708738,1.32051282051282
28,"Slardar",110,"Phoenix",83,73,156,0.532051282051282,2
28,"Slardar",111,"Oracle",56,37,93,0.602150537634409,1.19230769230769
28,"Slardar",112,"Winter Wyvern",446,354,800,0.5575,10.2564102564103
29,"Tidehunter",30,"Witch Doctor",63,82,145,0.43448275862069,1.85897435897436
29,"Tidehunter",31,"Lich",37,23,60,0.616666666666667,0.769230769230769
29,"Tidehunter",32,"Riki",35,35,70,0.5,0.897435897435897
29,"Tidehunter",33,"Enigma",25,25,50,0.5,0.641025641025641
29,"Tidehunter",34,"Tinker",17,36,53,0.320754716981132,0.67948717948718
29,"Tidehunter",35,"Sniper",33,51,84,0.392857142857143,1.07692307692308
29,"Tidehunter",36,"Necrophos",44,41,85,0.517647058823529,1.08974358974359
29,"Tidehunter",37,"Warlock",20,25,45,0.444444444444444,0.576923076923077
29,"Tidehunter",38,"Beastmaster",5,8,13,0.384615384615385,0.166666666666667
29,"Tidehunter",39,"Queen of Pain",79,95,174,0.454022988505747,2.23076923076923
29,"Tidehunter",40,"Venomancer",27,22,49,0.551020408163265,0.628205128205128
29,"Tidehunter",41,"Faceless Void",29,42,71,0.408450704225352,0.91025641025641
29,"Tidehunter",42,"Wraith King",56,57,113,0.495575221238938,1.44871794871795
29,"Tidehunter",43,"Death Prophet",12,8,20,0.6,0.256410256410256
29,"Tidehunter",44,"Phantom Assassin",65,74,139,0.467625899280576,1.78205128205128
29,"Tidehunter",45,"Pugna",10,18,28,0.357142857142857,0.358974358974359
29,"Tidehunter",46,"Templar Assassin",65,63,128,0.5078125,1.64102564102564
29,"Tidehunter",47,"Viper",27,44,71,0.380281690140845,0.91025641025641
29,"Tidehunter",48,"Luna",31,25,56,0.553571428571429,0.717948717948718
29,"Tidehunter",49,"Dragon Knight",16,8,24,0.666666666666667,0.307692307692308
29,"Tidehunter",50,"Dazzle",89,68,157,0.56687898089172,2.01282051282051
29,"Tidehunter",51,"Clockwerk",15,14,29,0.517241379310345,0.371794871794872
29,"Tidehunter",52,"Leshrac",12,15,27,0.444444444444444,0.346153846153846
29,"Tidehunter",53,"Nature's Prophet",24,25,49,0.489795918367347,0.628205128205128
29,"Tidehunter",54,"Lifestealer",27,41,68,0.397058823529412,0.871794871794872
29,"Tidehunter",55,"Dark Seer",18,15,33,0.545454545454545,0.423076923076923
29,"Tidehunter",56,"Clinkz",26,14,40,0.65,0.512820512820513
29,"Tidehunter",57,"Omniknight",49,29,78,0.628205128205128,1
29,"Tidehunter",58,"Enchantress",6,11,17,0.352941176470588,0.217948717948718
29,"Tidehunter",59,"Huskar",25,31,56,0.446428571428571,0.717948717948718
29,"Tidehunter",60,"Night Stalker",25,10,35,0.714285714285714,0.448717948717949
29,"Tidehunter",61,"Broodmother",3,8,11,0.272727272727273,0.141025641025641
29,"Tidehunter",62,"Bounty Hunter",45,53,98,0.459183673469388,1.25641025641026
29,"Tidehunter",63,"Weaver",31,29,60,0.516666666666667,0.769230769230769
29,"Tidehunter",64,"Jakiro",27,22,49,0.551020408163265,0.628205128205128
29,"Tidehunter",65,"Batrider",2,5,7,0.285714285714286,0.0897435897435897
29,"Tidehunter",66,"Chen",1,12,13,0.0769230769230769,0.166666666666667
29,"Tidehunter",67,"Spectre",94,52,146,0.643835616438356,1.87179487179487
29,"Tidehunter",68,"Ancient Apparition",50,63,113,0.442477876106195,1.44871794871795
29,"Tidehunter",69,"Doom",40,47,87,0.459770114942529,1.11538461538462
29,"Tidehunter",70,"Ursa",43,35,78,0.551282051282051,1
29,"Tidehunter",71,"Spirit Breaker",36,30,66,0.545454545454545,0.846153846153846
29,"Tidehunter",72,"Gyrocopter",63,83,146,0.431506849315068,1.87179487179487
29,"Tidehunter",73,"Alchemist",85,82,167,0.508982035928144,2.14102564102564
29,"Tidehunter",74,"Invoker",110,123,233,0.472103004291845,2.98717948717949
29,"Tidehunter",75,"Silencer",64,67,131,0.488549618320611,1.67948717948718
29,"Tidehunter",76,"Outworld Devourer",7,17,24,0.291666666666667,0.307692307692308
29,"Tidehunter",77,"Lycan",10,15,25,0.4,0.320512820512821
29,"Tidehunter",78,"Brewmaster",4,7,11,0.363636363636364,0.141025641025641
29,"Tidehunter",79,"Shadow Demon",15,11,26,0.576923076923077,0.333333333333333
29,"Tidehunter",80,"Lone Druid",3,12,15,0.2,0.192307692307692
29,"Tidehunter",81,"Chaos Knight",22,24,46,0.478260869565217,0.58974358974359
29,"Tidehunter",82,"Meepo",15,13,28,0.535714285714286,0.358974358974359
29,"Tidehunter",83,"Treant Protector",13,17,30,0.433333333333333,0.384615384615385
29,"Tidehunter",84,"Ogre Magi",39,26,65,0.6,0.833333333333333
29,"Tidehunter",85,"Undying",33,30,63,0.523809523809524,0.807692307692308
29,"Tidehunter",86,"Rubick",62,76,138,0.449275362318841,1.76923076923077
29,"Tidehunter",87,"Disruptor",51,49,100,0.51,1.28205128205128
29,"Tidehunter",88,"Nyx Assassin",15,17,32,0.46875,0.41025641025641
29,"Tidehunter",89,"Naga Siren",8,10,18,0.444444444444444,0.230769230769231
29,"Tidehunter",90,"Keeper of the Light",20,14,34,0.588235294117647,0.435897435897436
29,"Tidehunter",91,"Io",13,20,33,0.393939393939394,0.423076923076923
29,"Tidehunter",92,"Visage",9,17,26,0.346153846153846,0.333333333333333
29,"Tidehunter",93,"Slark",70,80,150,0.466666666666667,1.92307692307692
29,"Tidehunter",94,"Medusa",23,20,43,0.534883720930233,0.551282051282051
29,"Tidehunter",95,"Troll Warlord",19,16,35,0.542857142857143,0.448717948717949
29,"Tidehunter",96,"Centaur Warrunner",5,7,12,0.416666666666667,0.153846153846154
29,"Tidehunter",97,"Magnus",17,27,44,0.386363636363636,0.564102564102564
29,"Tidehunter",98,"Timbersaw",17,11,28,0.607142857142857,0.358974358974359
29,"Tidehunter",99,"Bristleback",17,19,36,0.472222222222222,0.461538461538462
29,"Tidehunter",100,"Tusk",62,49,111,0.558558558558559,1.42307692307692
29,"Tidehunter",101,"Skywrath Mage",30,34,64,0.46875,0.82051282051282
29,"Tidehunter",102,"Abaddon",19,21,40,0.475,0.512820512820513
29,"Tidehunter",103,"Elder Titan",3,3,6,0.5,0.0769230769230769
29,"Tidehunter",104,"Legion Commander",75,65,140,0.535714285714286,1.79487179487179
29,"Tidehunter",105,"Techies",6,6,12,0.5,0.153846153846154
29,"Tidehunter",106,"Ember Spirit",67,74,141,0.475177304964539,1.80769230769231
29,"Tidehunter",107,"Earth Spirit",12,16,28,0.428571428571429,0.358974358974359
29,"Tidehunter",109,"Terrorblade",14,10,24,0.583333333333333,0.307692307692308
29,"Tidehunter",110,"Phoenix",20,14,34,0.588235294117647,0.435897435897436
29,"Tidehunter",111,"Oracle",12,15,27,0.444444444444444,0.346153846153846
29,"Tidehunter",112,"Winter Wyvern",64,76,140,0.457142857142857,1.79487179487179
30,"Witch Doctor",31,"Lich",102,71,173,0.589595375722543,2.21794871794872
30,"Witch Doctor",32,"Riki",117,98,215,0.544186046511628,2.75641025641026
30,"Witch Doctor",33,"Enigma",62,66,128,0.484375,1.64102564102564
30,"Witch Doctor",34,"Tinker",63,58,121,0.520661157024793,1.55128205128205
30,"Witch Doctor",35,"Sniper",92,104,196,0.469387755102041,2.51282051282051
30,"Witch Doctor",36,"Necrophos",199,124,323,0.61609907120743,4.14102564102564
30,"Witch Doctor",37,"Warlock",40,30,70,0.571428571428571,0.897435897435897
30,"Witch Doctor",38,"Beastmaster",36,30,66,0.545454545454545,0.846153846153846
30,"Witch Doctor",39,"Queen of Pain",278,349,627,0.443381180223285,8.03846153846154
30,"Witch Doctor",40,"Venomancer",70,55,125,0.56,1.6025641025641
30,"Witch Doctor",41,"Faceless Void",158,196,354,0.446327683615819,4.53846153846154
30,"Witch Doctor",42,"Wraith King",293,203,496,0.590725806451613,6.35897435897436
30,"Witch Doctor",43,"Death Prophet",53,51,104,0.509615384615385,1.33333333333333
30,"Witch Doctor",44,"Phantom Assassin",233,239,472,0.49364406779661,6.05128205128205
30,"Witch Doctor",45,"Pugna",28,22,50,0.56,0.641025641025641
30,"Witch Doctor",46,"Templar Assassin",174,193,367,0.474114441416894,4.70512820512821
30,"Witch Doctor",47,"Viper",133,120,253,0.525691699604743,3.24358974358974
30,"Witch Doctor",48,"Luna",88,69,157,0.560509554140127,2.01282051282051
30,"Witch Doctor",49,"Dragon Knight",56,58,114,0.491228070175439,1.46153846153846
30,"Witch Doctor",50,"Dazzle",124,103,227,0.54625550660793,2.91025641025641
30,"Witch Doctor",51,"Clockwerk",137,155,292,0.469178082191781,3.74358974358974
30,"Witch Doctor",52,"Leshrac",21,31,52,0.403846153846154,0.666666666666667
30,"Witch Doctor",53,"Nature's Prophet",69,93,162,0.425925925925926,2.07692307692308
30,"Witch Doctor",54,"Lifestealer",81,74,155,0.52258064516129,1.98717948717949
30,"Witch Doctor",55,"Dark Seer",116,118,234,0.495726495726496,3
30,"Witch Doctor",56,"Clinkz",64,93,157,0.407643312101911,2.01282051282051
30,"Witch Doctor",57,"Omniknight",124,70,194,0.639175257731959,2.48717948717949
30,"Witch Doctor",58,"Enchantress",13,20,33,0.393939393939394,0.423076923076923
30,"Witch Doctor",59,"Huskar",96,96,192,0.5,2.46153846153846
30,"Witch Doctor",60,"Night Stalker",88,85,173,0.508670520231214,2.21794871794872
30,"Witch Doctor",61,"Broodmother",41,45,86,0.476744186046512,1.1025641025641
30,"Witch Doctor",62,"Bounty Hunter",144,142,286,0.503496503496504,3.66666666666667
30,"Witch Doctor",63,"Weaver",63,63,126,0.5,1.61538461538462
30,"Witch Doctor",64,"Jakiro",53,48,101,0.524752475247525,1.29487179487179
30,"Witch Doctor",65,"Batrider",19,20,39,0.487179487179487,0.5
30,"Witch Doctor",66,"Chen",4,10,14,0.285714285714286,0.179487179487179
30,"Witch Doctor",67,"Spectre",252,168,420,0.6,5.38461538461539
30,"Witch Doctor",68,"Ancient Apparition",119,101,220,0.540909090909091,2.82051282051282
30,"Witch Doctor",69,"Doom",248,193,441,0.562358276643991,5.65384615384615
30,"Witch Doctor",70,"Ursa",127,81,208,0.610576923076923,2.66666666666667
30,"Witch Doctor",71,"Spirit Breaker",210,164,374,0.561497326203209,4.79487179487179
30,"Witch Doctor",72,"Gyrocopter",212,207,419,0.505966587112172,5.37179487179487
30,"Witch Doctor",73,"Alchemist",320,292,612,0.522875816993464,7.84615384615385
30,"Witch Doctor",74,"Invoker",293,297,590,0.496610169491525,7.56410256410256
30,"Witch Doctor",75,"Silencer",154,120,274,0.562043795620438,3.51282051282051
30,"Witch Doctor",76,"Outworld Devourer",45,48,93,0.483870967741935,1.19230769230769
30,"Witch Doctor",77,"Lycan",35,21,56,0.625,0.717948717948718
30,"Witch Doctor",78,"Brewmaster",30,22,52,0.576923076923077,0.666666666666667
30,"Witch Doctor",79,"Shadow Demon",14,28,42,0.333333333333333,0.538461538461538
30,"Witch Doctor",80,"Lone Druid",23,20,43,0.534883720930233,0.551282051282051
30,"Witch Doctor",81,"Chaos Knight",75,79,154,0.487012987012987,1.97435897435897
30,"Witch Doctor",82,"Meepo",44,44,88,0.5,1.12820512820513
30,"Witch Doctor",83,"Treant Protector",34,38,72,0.472222222222222,0.923076923076923
30,"Witch Doctor",84,"Ogre Magi",87,63,150,0.58,1.92307692307692
30,"Witch Doctor",85,"Undying",195,131,326,0.598159509202454,4.17948717948718
30,"Witch Doctor",86,"Rubick",104,114,218,0.477064220183486,2.79487179487179
30,"Witch Doctor",87,"Disruptor",68,73,141,0.482269503546099,1.80769230769231
30,"Witch Doctor",88,"Nyx Assassin",84,73,157,0.535031847133758,2.01282051282051
30,"Witch Doctor",89,"Naga Siren",17,33,50,0.34,0.641025641025641
30,"Witch Doctor",90,"Keeper of the Light",28,27,55,0.509090909090909,0.705128205128205
30,"Witch Doctor",91,"Io",21,34,55,0.381818181818182,0.705128205128205
30,"Witch Doctor",92,"Visage",15,26,41,0.365853658536585,0.525641025641026
30,"Witch Doctor",93,"Slark",258,233,491,0.525458248472505,6.29487179487179
30,"Witch Doctor",94,"Medusa",79,57,136,0.580882352941177,1.74358974358974
30,"Witch Doctor",95,"Troll Warlord",52,54,106,0.490566037735849,1.35897435897436
30,"Witch Doctor",96,"Centaur Warrunner",68,54,122,0.557377049180328,1.56410256410256
30,"Witch Doctor",97,"Magnus",102,138,240,0.425,3.07692307692308
30,"Witch Doctor",98,"Timbersaw",85,101,186,0.456989247311828,2.38461538461538
30,"Witch Doctor",99,"Bristleback",143,128,271,0.527675276752767,3.47435897435897
30,"Witch Doctor",100,"Tusk",291,248,539,0.539888682745826,6.91025641025641
30,"Witch Doctor",101,"Skywrath Mage",36,51,87,0.413793103448276,1.11538461538462
30,"Witch Doctor",102,"Abaddon",84,62,146,0.575342465753425,1.87179487179487
30,"Witch Doctor",103,"Elder Titan",23,24,47,0.48936170212766,0.602564102564103
30,"Witch Doctor",104,"Legion Commander",251,255,506,0.49604743083004,6.48717948717949
30,"Witch Doctor",105,"Techies",15,25,40,0.375,0.512820512820513
30,"Witch Doctor",106,"Ember Spirit",239,238,477,0.50104821802935,6.11538461538461
30,"Witch Doctor",107,"Earth Spirit",72,61,133,0.541353383458647,1.70512820512821
30,"Witch Doctor",109,"Terrorblade",40,39,79,0.506329113924051,1.01282051282051
30,"Witch Doctor",110,"Phoenix",113,74,187,0.60427807486631,2.3974358974359
30,"Witch Doctor",111,"Oracle",16,11,27,0.592592592592593,0.346153846153846
30,"Witch Doctor",112,"Winter Wyvern",113,103,216,0.523148148148148,2.76923076923077
31,"Lich",32,"Riki",77,44,121,0.636363636363636,1.55128205128205
31,"Lich",33,"Enigma",38,38,76,0.5,0.974358974358974
31,"Lich",34,"Tinker",36,50,86,0.418604651162791,1.1025641025641
31,"Lich",35,"Sniper",66,57,123,0.536585365853659,1.57692307692308
31,"Lich",36,"Necrophos",96,53,149,0.644295302013423,1.91025641025641
31,"Lich",37,"Warlock",21,14,35,0.6,0.448717948717949
31,"Lich",38,"Beastmaster",24,18,42,0.571428571428571,0.538461538461538
31,"Lich",39,"Queen of Pain",203,202,405,0.501234567901235,5.19230769230769
31,"Lich",40,"Venomancer",48,31,79,0.607594936708861,1.01282051282051
31,"Lich",41,"Faceless Void",68,77,145,0.468965517241379,1.85897435897436
31,"Lich",42,"Wraith King",251,99,350,0.717142857142857,4.48717948717949
31,"Lich",43,"Death Prophet",24,19,43,0.558139534883721,0.551282051282051
31,"Lich",44,"Phantom Assassin",130,131,261,0.498084291187739,3.34615384615385
31,"Lich",45,"Pugna",11,13,24,0.458333333333333,0.307692307692308
31,"Lich",46,"Templar Assassin",140,84,224,0.625,2.87179487179487
31,"Lich",47,"Viper",64,58,122,0.524590163934426,1.56410256410256
31,"Lich",48,"Luna",59,35,94,0.627659574468085,1.20512820512821
31,"Lich",49,"Dragon Knight",33,35,68,0.485294117647059,0.871794871794872
31,"Lich",50,"Dazzle",91,70,161,0.565217391304348,2.06410256410256
31,"Lich",51,"Clockwerk",67,63,130,0.515384615384615,1.66666666666667
31,"Lich",52,"Leshrac",29,24,53,0.547169811320755,0.67948717948718
31,"Lich",53,"Nature's Prophet",37,38,75,0.493333333333333,0.961538461538462
31,"Lich",54,"Lifestealer",41,45,86,0.476744186046512,1.1025641025641
31,"Lich",55,"Dark Seer",60,61,121,0.495867768595041,1.55128205128205
31,"Lich",56,"Clinkz",50,37,87,0.574712643678161,1.11538461538462
31,"Lich",57,"Omniknight",57,39,96,0.59375,1.23076923076923
31,"Lich",58,"Enchantress",14,17,31,0.451612903225806,0.397435897435897
31,"Lich",59,"Huskar",85,47,132,0.643939393939394,1.69230769230769
31,"Lich",60,"Night Stalker",53,46,99,0.535353535353535,1.26923076923077
31,"Lich",61,"Broodmother",29,19,48,0.604166666666667,0.615384615384615
31,"Lich",62,"Bounty Hunter",87,79,166,0.524096385542169,2.12820512820513
31,"Lich",63,"Weaver",40,35,75,0.533333333333333,0.961538461538462
31,"Lich",64,"Jakiro",30,26,56,0.535714285714286,0.717948717948718
31,"Lich",65,"Batrider",12,16,28,0.428571428571429,0.358974358974359
31,"Lich",66,"Chen",7,7,14,0.5,0.179487179487179
31,"Lich",67,"Spectre",169,85,254,0.665354330708661,3.25641025641026
31,"Lich",68,"Ancient Apparition",91,52,143,0.636363636363636,1.83333333333333
31,"Lich",69,"Doom",314,187,501,0.626746506986028,6.42307692307692
31,"Lich",70,"Ursa",79,53,132,0.598484848484849,1.69230769230769
31,"Lich",71,"Spirit Breaker",142,101,243,0.584362139917695,3.11538461538462
31,"Lich",72,"Gyrocopter",136,130,266,0.511278195488722,3.41025641025641
31,"Lich",73,"Alchemist",212,152,364,0.582417582417582,4.66666666666667
31,"Lich",74,"Invoker",225,148,373,0.603217158176944,4.78205128205128
31,"Lich",75,"Silencer",108,75,183,0.590163934426229,2.34615384615385
31,"Lich",76,"Outworld Devourer",25,18,43,0.581395348837209,0.551282051282051
31,"Lich",77,"Lycan",15,12,27,0.555555555555556,0.346153846153846
31,"Lich",78,"Brewmaster",16,20,36,0.444444444444444,0.461538461538462
31,"Lich",79,"Shadow Demon",14,9,23,0.608695652173913,0.294871794871795
31,"Lich",80,"Lone Druid",17,18,35,0.485714285714286,0.448717948717949
31,"Lich",81,"Chaos Knight",47,39,86,0.546511627906977,1.1025641025641
31,"Lich",82,"Meepo",34,26,60,0.566666666666667,0.769230769230769
31,"Lich",83,"Treant Protector",19,23,42,0.452380952380952,0.538461538461538
31,"Lich",84,"Ogre Magi",62,40,102,0.607843137254902,1.30769230769231
31,"Lich",85,"Undying",109,71,180,0.605555555555556,2.30769230769231
31,"Lich",86,"Rubick",84,68,152,0.552631578947368,1.94871794871795
31,"Lich",87,"Disruptor",83,42,125,0.664,1.6025641025641
31,"Lich",88,"Nyx Assassin",24,30,54,0.444444444444444,0.692307692307692
31,"Lich",89,"Naga Siren",13,16,29,0.448275862068966,0.371794871794872
31,"Lich",90,"Keeper of the Light",13,21,34,0.382352941176471,0.435897435897436
31,"Lich",91,"Io",17,20,37,0.459459459459459,0.474358974358974
31,"Lich",92,"Visage",10,14,24,0.416666666666667,0.307692307692308
31,"Lich",93,"Slark",159,146,305,0.521311475409836,3.91025641025641
31,"Lich",94,"Medusa",31,32,63,0.492063492063492,0.807692307692308
31,"Lich",95,"Troll Warlord",24,21,45,0.533333333333333,0.576923076923077
31,"Lich",96,"Centaur Warrunner",24,33,57,0.421052631578947,0.730769230769231
31,"Lich",97,"Magnus",75,94,169,0.443786982248521,2.16666666666667
31,"Lich",98,"Timbersaw",50,60,110,0.454545454545455,1.41025641025641
31,"Lich",99,"Bristleback",64,71,135,0.474074074074074,1.73076923076923
31,"Lich",100,"Tusk",199,143,342,0.58187134502924,4.38461538461539
31,"Lich",101,"Skywrath Mage",36,38,74,0.486486486486487,0.948717948717949
31,"Lich",102,"Abaddon",60,35,95,0.631578947368421,1.21794871794872
31,"Lich",103,"Elder Titan",11,8,19,0.578947368421053,0.243589743589744
31,"Lich",104,"Legion Commander",142,137,279,0.508960573476703,3.57692307692308
31,"Lich",105,"Techies",9,17,26,0.346153846153846,0.333333333333333
31,"Lich",106,"Ember Spirit",168,136,304,0.552631578947368,3.8974358974359
31,"Lich",107,"Earth Spirit",51,38,89,0.573033707865168,1.14102564102564
31,"Lich",109,"Terrorblade",33,21,54,0.611111111111111,0.692307692307692
31,"Lich",110,"Phoenix",41,37,78,0.525641025641026,1
31,"Lich",111,"Oracle",9,6,15,0.6,0.192307692307692
31,"Lich",112,"Winter Wyvern",111,84,195,0.569230769230769,2.5
32,"Riki",33,"Enigma",39,34,73,0.534246575342466,0.935897435897436
32,"Riki",34,"Tinker",53,44,97,0.54639175257732,1.24358974358974
32,"Riki",35,"Sniper",70,58,128,0.546875,1.64102564102564
32,"Riki",36,"Necrophos",113,73,186,0.60752688172043,2.38461538461538
32,"Riki",37,"Warlock",33,24,57,0.578947368421053,0.730769230769231
32,"Riki",38,"Beastmaster",19,14,33,0.575757575757576,0.423076923076923
32,"Riki",39,"Queen of Pain",156,137,293,0.532423208191126,3.75641025641026
32,"Riki",40,"Venomancer",56,33,89,0.629213483146067,1.14102564102564
32,"Riki",41,"Faceless Void",38,46,84,0.452380952380952,1.07692307692308
32,"Riki",42,"Wraith King",133,67,200,0.665,2.56410256410256
32,"Riki",43,"Death Prophet",28,42,70,0.4,0.897435897435897
32,"Riki",44,"Phantom Assassin",89,96,185,0.481081081081081,2.37179487179487
32,"Riki",45,"Pugna",24,27,51,0.470588235294118,0.653846153846154
32,"Riki",46,"Templar Assassin",90,69,159,0.566037735849057,2.03846153846154
32,"Riki",47,"Viper",69,48,117,0.58974358974359,1.5
32,"Riki",48,"Luna",38,27,65,0.584615384615385,0.833333333333333
32,"Riki",49,"Dragon Knight",23,28,51,0.450980392156863,0.653846153846154
32,"Riki",50,"Dazzle",132,99,231,0.571428571428571,2.96153846153846
32,"Riki",51,"Clockwerk",39,36,75,0.52,0.961538461538462
32,"Riki",52,"Leshrac",19,15,34,0.558823529411765,0.435897435897436
32,"Riki",53,"Nature's Prophet",47,57,104,0.451923076923077,1.33333333333333
32,"Riki",54,"Lifestealer",42,32,74,0.567567567567568,0.948717948717949
32,"Riki",55,"Dark Seer",78,43,121,0.644628099173554,1.55128205128205
32,"Riki",56,"Clinkz",19,17,36,0.527777777777778,0.461538461538462
32,"Riki",57,"Omniknight",101,56,157,0.643312101910828,2.01282051282051
32,"Riki",58,"Enchantress",10,14,24,0.416666666666667,0.307692307692308
32,"Riki",59,"Huskar",57,60,117,0.487179487179487,1.5
32,"Riki",60,"Night Stalker",40,28,68,0.588235294117647,0.871794871794872
32,"Riki",61,"Broodmother",9,23,32,0.28125,0.41025641025641
32,"Riki",62,"Bounty Hunter",45,54,99,0.454545454545455,1.26923076923077
32,"Riki",63,"Weaver",23,34,57,0.403508771929825,0.730769230769231
32,"Riki",64,"Jakiro",58,28,86,0.674418604651163,1.1025641025641
32,"Riki",65,"Batrider",20,14,34,0.588235294117647,0.435897435897436
32,"Riki",66,"Chen",10,7,17,0.588235294117647,0.217948717948718
32,"Riki",67,"Spectre",83,62,145,0.572413793103448,1.85897435897436
32,"Riki",68,"Ancient Apparition",98,80,178,0.550561797752809,2.28205128205128
32,"Riki",69,"Doom",111,59,170,0.652941176470588,2.17948717948718
32,"Riki",70,"Ursa",77,52,129,0.596899224806202,1.65384615384615
32,"Riki",71,"Spirit Breaker",138,88,226,0.610619469026549,2.8974358974359
32,"Riki",72,"Gyrocopter",94,78,172,0.546511627906977,2.20512820512821
32,"Riki",73,"Alchemist",177,100,277,0.63898916967509,3.55128205128205
32,"Riki",74,"Invoker",185,175,360,0.513888888888889,4.61538461538461
32,"Riki",75,"Silencer",124,91,215,0.576744186046512,2.75641025641026
32,"Riki",76,"Outworld Devourer",32,22,54,0.592592592592593,0.692307692307692
32,"Riki",77,"Lycan",14,12,26,0.538461538461538,0.333333333333333
32,"Riki",78,"Brewmaster",19,13,32,0.59375,0.41025641025641
32,"Riki",79,"Shadow Demon",21,28,49,0.428571428571429,0.628205128205128
32,"Riki",80,"Lone Druid",14,21,35,0.4,0.448717948717949
32,"Riki",81,"Chaos Knight",42,27,69,0.608695652173913,0.884615384615385
32,"Riki",82,"Meepo",30,19,49,0.612244897959184,0.628205128205128
32,"Riki",83,"Treant Protector",27,21,48,0.5625,0.615384615384615
32,"Riki",84,"Ogre Magi",80,58,138,0.579710144927536,1.76923076923077
32,"Riki",85,"Undying",92,49,141,0.652482269503546,1.80769230769231
32,"Riki",86,"Rubick",104,116,220,0.472727272727273,2.82051282051282
32,"Riki",87,"Disruptor",64,52,116,0.551724137931034,1.48717948717949
32,"Riki",88,"Nyx Assassin",31,28,59,0.525423728813559,0.756410256410256
32,"Riki",89,"Naga Siren",9,9,18,0.5,0.230769230769231
32,"Riki",90,"Keeper of the Light",36,26,62,0.580645161290323,0.794871794871795
32,"Riki",91,"Io",21,24,45,0.466666666666667,0.576923076923077
32,"Riki",92,"Visage",18,6,24,0.75,0.307692307692308
32,"Riki",93,"Slark",86,96,182,0.472527472527473,2.33333333333333
32,"Riki",94,"Medusa",41,25,66,0.621212121212121,0.846153846153846
32,"Riki",95,"Troll Warlord",23,21,44,0.522727272727273,0.564102564102564
32,"Riki",96,"Centaur Warrunner",30,16,46,0.652173913043478,0.58974358974359
32,"Riki",97,"Magnus",40,39,79,0.506329113924051,1.01282051282051
32,"Riki",98,"Timbersaw",39,39,78,0.5,1
32,"Riki",99,"Bristleback",67,58,125,0.536,1.6025641025641
32,"Riki",100,"Tusk",118,135,253,0.466403162055336,3.24358974358974
32,"Riki",101,"Skywrath Mage",29,42,71,0.408450704225352,0.91025641025641
32,"Riki",102,"Abaddon",56,34,90,0.622222222222222,1.15384615384615
32,"Riki",103,"Elder Titan",9,11,20,0.45,0.256410256410256
32,"Riki",104,"Legion Commander",147,127,274,0.536496350364963,3.51282051282051
32,"Riki",105,"Techies",23,16,39,0.58974358974359,0.5
32,"Riki",106,"Ember Spirit",116,88,204,0.568627450980392,2.61538461538462
32,"Riki",107,"Earth Spirit",37,32,69,0.536231884057971,0.884615384615385
32,"Riki",109,"Terrorblade",28,22,50,0.56,0.641025641025641
32,"Riki",110,"Phoenix",45,25,70,0.642857142857143,0.897435897435897
32,"Riki",111,"Oracle",18,9,27,0.666666666666667,0.346153846153846
32,"Riki",112,"Winter Wyvern",120,82,202,0.594059405940594,2.58974358974359
33,"Enigma",34,"Tinker",19,22,41,0.463414634146341,0.525641025641026
33,"Enigma",35,"Sniper",17,50,67,0.253731343283582,0.858974358974359
33,"Enigma",36,"Necrophos",62,33,95,0.652631578947368,1.21794871794872
33,"Enigma",37,"Warlock",15,7,22,0.681818181818182,0.282051282051282
33,"Enigma",38,"Beastmaster",15,13,28,0.535714285714286,0.358974358974359
33,"Enigma",39,"Queen of Pain",103,105,208,0.495192307692308,2.66666666666667
33,"Enigma",40,"Venomancer",12,25,37,0.324324324324324,0.474358974358974
33,"Enigma",41,"Faceless Void",19,41,60,0.316666666666667,0.769230769230769
33,"Enigma",42,"Wraith King",56,47,103,0.543689320388349,1.32051282051282
33,"Enigma",43,"Death Prophet",21,16,37,0.567567567567568,0.474358974358974
33,"Enigma",44,"Phantom Assassin",65,86,151,0.43046357615894,1.93589743589744
33,"Enigma",45,"Pugna",8,14,22,0.363636363636364,0.282051282051282
33,"Enigma",46,"Templar Assassin",67,72,139,0.482014388489209,1.78205128205128
33,"Enigma",47,"Viper",36,24,60,0.6,0.769230769230769
33,"Enigma",48,"Luna",25,18,43,0.581395348837209,0.551282051282051
33,"Enigma",49,"Dragon Knight",15,23,38,0.394736842105263,0.487179487179487
33,"Enigma",50,"Dazzle",67,59,126,0.531746031746032,1.61538461538462
33,"Enigma",51,"Clockwerk",51,38,89,0.573033707865168,1.14102564102564
33,"Enigma",52,"Leshrac",12,11,23,0.521739130434783,0.294871794871795
33,"Enigma",53,"Nature's Prophet",14,12,26,0.538461538461538,0.333333333333333
33,"Enigma",54,"Lifestealer",11,15,26,0.423076923076923,0.333333333333333
33,"Enigma",55,"Dark Seer",56,62,118,0.474576271186441,1.51282051282051
33,"Enigma",56,"Clinkz",17,30,47,0.361702127659574,0.602564102564103
33,"Enigma",57,"Omniknight",37,19,56,0.660714285714286,0.717948717948718
33,"Enigma",58,"Enchantress",8,6,14,0.571428571428571,0.179487179487179
33,"Enigma",59,"Huskar",39,26,65,0.6,0.833333333333333
33,"Enigma",60,"Night Stalker",32,16,48,0.666666666666667,0.615384615384615
33,"Enigma",61,"Broodmother",14,17,31,0.451612903225806,0.397435897435897
33,"Enigma",62,"Bounty Hunter",35,39,74,0.472972972972973,0.948717948717949
33,"Enigma",63,"Weaver",24,19,43,0.558139534883721,0.551282051282051
33,"Enigma",64,"Jakiro",20,14,34,0.588235294117647,0.435897435897436
33,"Enigma",65,"Batrider",14,6,20,0.7,0.256410256410256
33,"Enigma",66,"Chen",0,3,3,0,0.0384615384615385
33,"Enigma",67,"Spectre",78,58,136,0.573529411764706,1.74358974358974
33,"Enigma",68,"Ancient Apparition",43,36,79,0.544303797468354,1.01282051282051
33,"Enigma",69,"Doom",63,37,100,0.63,1.28205128205128
33,"Enigma",70,"Ursa",31,31,62,0.5,0.794871794871795
33,"Enigma",71,"Spirit Breaker",55,46,101,0.544554455445545,1.29487179487179
33,"Enigma",72,"Gyrocopter",74,86,160,0.4625,2.05128205128205
33,"Enigma",73,"Alchemist",105,90,195,0.538461538461538,2.5
33,"Enigma",74,"Invoker",126,132,258,0.488372093023256,3.30769230769231
33,"Enigma",75,"Silencer",69,61,130,0.530769230769231,1.66666666666667
33,"Enigma",76,"Outworld Devourer",16,22,38,0.421052631578947,0.487179487179487
33,"Enigma",77,"Lycan",9,15,24,0.375,0.307692307692308
33,"Enigma",78,"Brewmaster",10,4,14,0.714285714285714,0.179487179487179
33,"Enigma",79,"Shadow Demon",11,9,20,0.55,0.256410256410256
33,"Enigma",80,"Lone Druid",4,3,7,0.571428571428571,0.0897435897435897
33,"Enigma",81,"Chaos Knight",20,27,47,0.425531914893617,0.602564102564103
33,"Enigma",82,"Meepo",12,18,30,0.4,0.384615384615385
33,"Enigma",83,"Treant Protector",15,13,28,0.535714285714286,0.358974358974359
33,"Enigma",84,"Ogre Magi",28,37,65,0.430769230769231,0.833333333333333
33,"Enigma",85,"Undying",43,41,84,0.511904761904762,1.07692307692308
33,"Enigma",86,"Rubick",50,61,111,0.45045045045045,1.42307692307692
33,"Enigma",87,"Disruptor",34,34,68,0.5,0.871794871794872
33,"Enigma",88,"Nyx Assassin",15,24,39,0.384615384615385,0.5
33,"Enigma",89,"Naga Siren",11,14,25,0.44,0.320512820512821
33,"Enigma",90,"Keeper of the Light",7,15,22,0.318181818181818,0.282051282051282
33,"Enigma",91,"Io",9,11,20,0.45,0.256410256410256
33,"Enigma",92,"Visage",9,5,14,0.642857142857143,0.179487179487179
33,"Enigma",93,"Slark",92,90,182,0.505494505494505,2.33333333333333
33,"Enigma",94,"Medusa",25,22,47,0.531914893617021,0.602564102564103
33,"Enigma",95,"Troll Warlord",20,16,36,0.555555555555556,0.461538461538462
33,"Enigma",96,"Centaur Warrunner",24,21,45,0.533333333333333,0.576923076923077
33,"Enigma",97,"Magnus",29,70,99,0.292929292929293,1.26923076923077
33,"Enigma",98,"Timbersaw",29,30,59,0.491525423728814,0.756410256410256
33,"Enigma",99,"Bristleback",47,46,93,0.505376344086022,1.19230769230769
33,"Enigma",100,"Tusk",76,76,152,0.5,1.94871794871795
33,"Enigma",101,"Skywrath Mage",16,19,35,0.457142857142857,0.448717948717949
33,"Enigma",102,"Abaddon",28,22,50,0.56,0.641025641025641
33,"Enigma",103,"Elder Titan",5,3,8,0.625,0.102564102564103
33,"Enigma",104,"Legion Commander",55,65,120,0.458333333333333,1.53846153846154
33,"Enigma",105,"Techies",5,4,9,0.555555555555556,0.115384615384615
33,"Enigma",106,"Ember Spirit",83,86,169,0.49112426035503,2.16666666666667
33,"Enigma",107,"Earth Spirit",16,27,43,0.372093023255814,0.551282051282051
33,"Enigma",109,"Terrorblade",20,14,34,0.588235294117647,0.435897435897436
33,"Enigma",110,"Phoenix",33,29,62,0.532258064516129,0.794871794871795
33,"Enigma",111,"Oracle",7,10,17,0.411764705882353,0.217948717948718
33,"Enigma",112,"Winter Wyvern",41,47,88,0.465909090909091,1.12820512820513
34,"Tinker",35,"Sniper",19,43,62,0.306451612903226,0.794871794871795
34,"Tinker",36,"Necrophos",56,47,103,0.543689320388349,1.32051282051282
34,"Tinker",37,"Warlock",14,18,32,0.4375,0.41025641025641
34,"Tinker",38,"Beastmaster",12,15,27,0.444444444444444,0.346153846153846
34,"Tinker",39,"Queen of Pain",28,54,82,0.341463414634146,1.05128205128205
34,"Tinker",40,"Venomancer",19,36,55,0.345454545454545,0.705128205128205
34,"Tinker",41,"Faceless Void",22,49,71,0.309859154929577,0.91025641025641
34,"Tinker",42,"Wraith King",82,78,160,0.5125,2.05128205128205
34,"Tinker",43,"Death Prophet",5,10,15,0.333333333333333,0.192307692307692
34,"Tinker",44,"Phantom Assassin",69,77,146,0.472602739726027,1.87179487179487
34,"Tinker",45,"Pugna",13,24,37,0.351351351351351,0.474358974358974
34,"Tinker",46,"Templar Assassin",14,18,32,0.4375,0.41025641025641
34,"Tinker",47,"Viper",18,32,50,0.36,0.641025641025641
34,"Tinker",48,"Luna",17,31,48,0.354166666666667,0.615384615384615
34,"Tinker",49,"Dragon Knight",12,24,36,0.333333333333333,0.461538461538462
34,"Tinker",50,"Dazzle",68,83,151,0.450331125827815,1.93589743589744
34,"Tinker",51,"Clockwerk",36,45,81,0.444444444444444,1.03846153846154
34,"Tinker",52,"Leshrac",9,10,19,0.473684210526316,0.243589743589744
34,"Tinker",53,"Nature's Prophet",20,52,72,0.277777777777778,0.923076923076923
34,"Tinker",54,"Lifestealer",32,38,70,0.457142857142857,0.897435897435897
34,"Tinker",55,"Dark Seer",27,33,60,0.45,0.769230769230769
34,"Tinker",56,"Clinkz",16,31,47,0.340425531914894,0.602564102564103
34,"Tinker",57,"Omniknight",56,58,114,0.491228070175439,1.46153846153846
34,"Tinker",58,"Enchantress",8,10,18,0.444444444444444,0.230769230769231
34,"Tinker",59,"Huskar",22,46,68,0.323529411764706,0.871794871794872
34,"Tinker",60,"Night Stalker",25,34,59,0.423728813559322,0.756410256410256
34,"Tinker",61,"Broodmother",10,18,28,0.357142857142857,0.358974358974359
34,"Tinker",62,"Bounty Hunter",68,103,171,0.39766081871345,2.19230769230769
34,"Tinker",63,"Weaver",22,21,43,0.511627906976744,0.551282051282051
34,"Tinker",64,"Jakiro",22,30,52,0.423076923076923,0.666666666666667
34,"Tinker",65,"Batrider",7,14,21,0.333333333333333,0.269230769230769
34,"Tinker",66,"Chen",3,5,8,0.375,0.102564102564103
34,"Tinker",67,"Spectre",75,79,154,0.487012987012987,1.97435897435897
34,"Tinker",68,"Ancient Apparition",44,64,108,0.407407407407407,1.38461538461538
34,"Tinker",69,"Doom",67,83,150,0.446666666666667,1.92307692307692
34,"Tinker",70,"Ursa",44,47,91,0.483516483516484,1.16666666666667
34,"Tinker",71,"Spirit Breaker",76,99,175,0.434285714285714,2.24358974358974
34,"Tinker",72,"Gyrocopter",49,71,120,0.408333333333333,1.53846153846154
34,"Tinker",73,"Alchemist",55,64,119,0.46218487394958,1.52564102564103
34,"Tinker",74,"Invoker",30,61,91,0.32967032967033,1.16666666666667
34,"Tinker",75,"Silencer",65,73,138,0.471014492753623,1.76923076923077
34,"Tinker",76,"Outworld Devourer",7,8,15,0.466666666666667,0.192307692307692
34,"Tinker",77,"Lycan",13,15,28,0.464285714285714,0.358974358974359
34,"Tinker",78,"Brewmaster",10,6,16,0.625,0.205128205128205
34,"Tinker",79,"Shadow Demon",9,17,26,0.346153846153846,0.333333333333333
34,"Tinker",80,"Lone Druid",6,15,21,0.285714285714286,0.269230769230769
34,"Tinker",81,"Chaos Knight",16,30,46,0.347826086956522,0.58974358974359
34,"Tinker",82,"Meepo",8,21,29,0.275862068965517,0.371794871794872
34,"Tinker",83,"Treant Protector",20,23,43,0.465116279069767,0.551282051282051
34,"Tinker",84,"Ogre Magi",43,60,103,0.41747572815534,1.32051282051282
34,"Tinker",85,"Undying",60,57,117,0.512820512820513,1.5
34,"Tinker",86,"Rubick",68,94,162,0.419753086419753,2.07692307692308
34,"Tinker",87,"Disruptor",54,45,99,0.545454545454545,1.26923076923077
34,"Tinker",88,"Nyx Assassin",16,20,36,0.444444444444444,0.461538461538462
34,"Tinker",89,"Naga Siren",6,9,15,0.4,0.192307692307692
34,"Tinker",90,"Keeper of the Light",16,26,42,0.380952380952381,0.538461538461538
34,"Tinker",91,"Io",9,16,25,0.36,0.320512820512821
34,"Tinker",92,"Visage",6,6,12,0.5,0.153846153846154
34,"Tinker",93,"Slark",93,111,204,0.455882352941176,2.61538461538462
34,"Tinker",94,"Medusa",18,10,28,0.642857142857143,0.358974358974359
34,"Tinker",95,"Troll Warlord",8,26,34,0.235294117647059,0.435897435897436
34,"Tinker",96,"Centaur Warrunner",18,22,40,0.45,0.512820512820513
34,"Tinker",97,"Magnus",19,26,45,0.422222222222222,0.576923076923077
34,"Tinker",98,"Timbersaw",24,32,56,0.428571428571429,0.717948717948718
34,"Tinker",99,"Bristleback",35,47,82,0.426829268292683,1.05128205128205
34,"Tinker",100,"Tusk",86,104,190,0.452631578947368,2.43589743589744
34,"Tinker",101,"Skywrath Mage",16,43,59,0.271186440677966,0.756410256410256
34,"Tinker",102,"Abaddon",39,39,78,0.5,1
34,"Tinker",103,"Elder Titan",5,13,18,0.277777777777778,0.230769230769231
34,"Tinker",104,"Legion Commander",86,127,213,0.403755868544601,2.73076923076923
34,"Tinker",105,"Techies",18,14,32,0.5625,0.41025641025641
34,"Tinker",106,"Ember Spirit",30,54,84,0.357142857142857,1.07692307692308
34,"Tinker",107,"Earth Spirit",24,27,51,0.470588235294118,0.653846153846154
34,"Tinker",109,"Terrorblade",11,18,29,0.379310344827586,0.371794871794872
34,"Tinker",110,"Phoenix",27,30,57,0.473684210526316,0.730769230769231
34,"Tinker",111,"Oracle",17,13,30,0.566666666666667,0.384615384615385
34,"Tinker",112,"Winter Wyvern",67,65,132,0.507575757575758,1.69230769230769
35,"Sniper",36,"Necrophos",99,87,186,0.532258064516129,2.38461538461538
35,"Sniper",37,"Warlock",37,38,75,0.493333333333333,0.961538461538462
35,"Sniper",38,"Beastmaster",10,14,24,0.416666666666667,0.307692307692308
35,"Sniper",39,"Queen of Pain",64,127,191,0.335078534031414,2.44871794871795
35,"Sniper",40,"Venomancer",46,52,98,0.469387755102041,1.25641025641026
35,"Sniper",41,"Faceless Void",44,67,111,0.396396396396396,1.42307692307692
35,"Sniper",42,"Wraith King",100,90,190,0.526315789473684,2.43589743589744
35,"Sniper",43,"Death Prophet",27,25,52,0.519230769230769,0.666666666666667
35,"Sniper",44,"Phantom Assassin",85,111,196,0.433673469387755,2.51282051282051
35,"Sniper",45,"Pugna",22,24,46,0.478260869565217,0.58974358974359
35,"Sniper",46,"Templar Assassin",43,60,103,0.41747572815534,1.32051282051282
35,"Sniper",47,"Viper",33,40,73,0.452054794520548,0.935897435897436
35,"Sniper",48,"Luna",30,37,67,0.447761194029851,0.858974358974359
35,"Sniper",49,"Dragon Knight",26,30,56,0.464285714285714,0.717948717948718
35,"Sniper",50,"Dazzle",96,103,199,0.482412060301508,2.55128205128205
35,"Sniper",51,"Clockwerk",49,50,99,0.494949494949495,1.26923076923077
35,"Sniper",52,"Leshrac",13,20,33,0.393939393939394,0.423076923076923
35,"Sniper",53,"Nature's Prophet",28,50,78,0.358974358974359,1
35,"Sniper",54,"Lifestealer",37,53,90,0.411111111111111,1.15384615384615
35,"Sniper",55,"Dark Seer",46,54,100,0.46,1.28205128205128
35,"Sniper",56,"Clinkz",18,33,51,0.352941176470588,0.653846153846154
35,"Sniper",57,"Omniknight",102,80,182,0.56043956043956,2.33333333333333
35,"Sniper",58,"Enchantress",9,18,27,0.333333333333333,0.346153846153846
35,"Sniper",59,"Huskar",38,65,103,0.368932038834951,1.32051282051282
35,"Sniper",60,"Night Stalker",41,53,94,0.436170212765957,1.20512820512821
35,"Sniper",61,"Broodmother",15,30,45,0.333333333333333,0.576923076923077
35,"Sniper",62,"Bounty Hunter",72,106,178,0.404494382022472,2.28205128205128
35,"Sniper",63,"Weaver",28,31,59,0.474576271186441,0.756410256410256
35,"Sniper",64,"Jakiro",37,40,77,0.480519480519481,0.987179487179487
35,"Sniper",65,"Batrider",14,15,29,0.482758620689655,0.371794871794872
35,"Sniper",66,"Chen",5,7,12,0.416666666666667,0.153846153846154
35,"Sniper",67,"Spectre",63,51,114,0.552631578947368,1.46153846153846
35,"Sniper",68,"Ancient Apparition",80,109,189,0.423280423280423,2.42307692307692
35,"Sniper",69,"Doom",99,92,191,0.518324607329843,2.44871794871795
35,"Sniper",70,"Ursa",76,48,124,0.612903225806452,1.58974358974359
35,"Sniper",71,"Spirit Breaker",108,114,222,0.486486486486487,2.84615384615385
35,"Sniper",72,"Gyrocopter",54,66,120,0.45,1.53846153846154
35,"Sniper",73,"Alchemist",118,140,258,0.457364341085271,3.30769230769231
35,"Sniper",74,"Invoker",107,161,268,0.399253731343284,3.43589743589744
35,"Sniper",75,"Silencer",82,97,179,0.458100558659218,2.29487179487179
35,"Sniper",76,"Outworld Devourer",12,18,30,0.4,0.384615384615385
35,"Sniper",77,"Lycan",9,24,33,0.272727272727273,0.423076923076923
35,"Sniper",78,"Brewmaster",10,12,22,0.454545454545455,0.282051282051282
35,"Sniper",79,"Shadow Demon",14,18,32,0.4375,0.41025641025641
35,"Sniper",80,"Lone Druid",8,17,25,0.32,0.320512820512821
35,"Sniper",81,"Chaos Knight",32,33,65,0.492307692307692,0.833333333333333
35,"Sniper",82,"Meepo",17,26,43,0.395348837209302,0.551282051282051
35,"Sniper",83,"Treant Protector",32,35,67,0.477611940298507,0.858974358974359
35,"Sniper",84,"Ogre Magi",83,82,165,0.503030303030303,2.11538461538462
35,"Sniper",85,"Undying",89,82,171,0.52046783625731,2.19230769230769
35,"Sniper",86,"Rubick",69,102,171,0.403508771929825,2.19230769230769
35,"Sniper",87,"Disruptor",50,50,100,0.5,1.28205128205128
35,"Sniper",88,"Nyx Assassin",27,39,66,0.409090909090909,0.846153846153846
35,"Sniper",89,"Naga Siren",4,11,15,0.266666666666667,0.192307692307692
35,"Sniper",90,"Keeper of the Light",31,43,74,0.418918918918919,0.948717948717949
35,"Sniper",91,"Io",14,17,31,0.451612903225806,0.397435897435897
35,"Sniper",92,"Visage",5,9,14,0.357142857142857,0.179487179487179
35,"Sniper",93,"Slark",70,78,148,0.472972972972973,1.8974358974359
35,"Sniper",94,"Medusa",22,38,60,0.366666666666667,0.769230769230769
35,"Sniper",95,"Troll Warlord",24,28,52,0.461538461538462,0.666666666666667
35,"Sniper",96,"Centaur Warrunner",27,33,60,0.45,0.769230769230769
35,"Sniper",97,"Magnus",32,50,82,0.390243902439024,1.05128205128205
35,"Sniper",98,"Timbersaw",25,57,82,0.304878048780488,1.05128205128205
35,"Sniper",99,"Bristleback",76,77,153,0.496732026143791,1.96153846153846
35,"Sniper",100,"Tusk",104,122,226,0.460176991150442,2.8974358974359
35,"Sniper",101,"Skywrath Mage",21,47,68,0.308823529411765,0.871794871794872
35,"Sniper",102,"Abaddon",67,43,110,0.609090909090909,1.41025641025641
35,"Sniper",103,"Elder Titan",17,17,34,0.5,0.435897435897436
35,"Sniper",104,"Legion Commander",119,197,316,0.376582278481013,4.05128205128205
35,"Sniper",105,"Techies",17,22,39,0.435897435897436,0.5
35,"Sniper",106,"Ember Spirit",73,95,168,0.43452380952381,2.15384615384615
35,"Sniper",107,"Earth Spirit",18,24,42,0.428571428571429,0.538461538461538
35,"Sniper",109,"Terrorblade",27,18,45,0.6,0.576923076923077
35,"Sniper",110,"Phoenix",39,32,71,0.549295774647887,0.91025641025641
35,"Sniper",111,"Oracle",12,13,25,0.48,0.320512820512821
35,"Sniper",112,"Winter Wyvern",69,107,176,0.392045454545455,2.25641025641026
36,"Necrophos",37,"Warlock",45,30,75,0.6,0.961538461538462
36,"Necrophos",38,"Beastmaster",31,23,54,0.574074074074074,0.692307692307692
36,"Necrophos",39,"Queen of Pain",199,175,374,0.532085561497326,4.79487179487179
36,"Necrophos",40,"Venomancer",55,52,107,0.514018691588785,1.37179487179487
36,"Necrophos",41,"Faceless Void",82,73,155,0.529032258064516,1.98717948717949
36,"Necrophos",42,"Wraith King",238,146,384,0.619791666666667,4.92307692307692
36,"Necrophos",43,"Death Prophet",39,40,79,0.493670886075949,1.01282051282051
36,"Necrophos",44,"Phantom Assassin",204,160,364,0.56043956043956,4.66666666666667
36,"Necrophos",45,"Pugna",32,20,52,0.615384615384615,0.666666666666667
36,"Necrophos",46,"Templar Assassin",153,110,263,0.581749049429658,3.37179487179487
36,"Necrophos",47,"Viper",86,69,155,0.554838709677419,1.98717948717949
36,"Necrophos",48,"Luna",74,38,112,0.660714285714286,1.43589743589744
36,"Necrophos",49,"Dragon Knight",58,42,100,0.58,1.28205128205128
36,"Necrophos",50,"Dazzle",157,106,263,0.596958174904943,3.37179487179487
36,"Necrophos",51,"Clockwerk",58,71,129,0.449612403100775,1.65384615384615
36,"Necrophos",52,"Leshrac",26,23,49,0.530612244897959,0.628205128205128
36,"Necrophos",53,"Nature's Prophet",69,70,139,0.496402877697842,1.78205128205128
36,"Necrophos",54,"Lifestealer",65,72,137,0.474452554744526,1.75641025641026
36,"Necrophos",55,"Dark Seer",56,55,111,0.504504504504504,1.42307692307692
36,"Necrophos",56,"Clinkz",36,45,81,0.444444444444444,1.03846153846154
36,"Necrophos",57,"Omniknight",140,66,206,0.679611650485437,2.64102564102564
36,"Necrophos",58,"Enchantress",21,14,35,0.6,0.448717948717949
36,"Necrophos",59,"Huskar",102,83,185,0.551351351351351,2.37179487179487
36,"Necrophos",60,"Night Stalker",77,58,135,0.57037037037037,1.73076923076923
36,"Necrophos",61,"Broodmother",26,40,66,0.393939393939394,0.846153846153846
36,"Necrophos",62,"Bounty Hunter",127,122,249,0.51004016064257,3.19230769230769
36,"Necrophos",63,"Weaver",54,41,95,0.568421052631579,1.21794871794872
36,"Necrophos",64,"Jakiro",62,44,106,0.584905660377358,1.35897435897436
36,"Necrophos",65,"Batrider",19,16,35,0.542857142857143,0.448717948717949
36,"Necrophos",66,"Chen",15,8,23,0.652173913043478,0.294871794871795
36,"Necrophos",67,"Spectre",217,105,322,0.673913043478261,4.12820512820513
36,"Necrophos",68,"Ancient Apparition",147,109,256,0.57421875,3.28205128205128
36,"Necrophos",69,"Doom",163,128,291,0.560137457044674,3.73076923076923
36,"Necrophos",70,"Ursa",102,79,181,0.56353591160221,2.32051282051282
36,"Necrophos",71,"Spirit Breaker",186,101,287,0.64808362369338,3.67948717948718
36,"Necrophos",72,"Gyrocopter",170,119,289,0.588235294117647,3.70512820512821
36,"Necrophos",73,"Alchemist",246,213,459,0.535947712418301,5.88461538461539
36,"Necrophos",74,"Invoker",280,189,469,0.597014925373134,6.01282051282051
36,"Necrophos",75,"Silencer",148,102,250,0.592,3.20512820512821
36,"Necrophos",76,"Outworld Devourer",30,25,55,0.545454545454545,0.705128205128205
36,"Necrophos",77,"Lycan",24,15,39,0.615384615384615,0.5
36,"Necrophos",78,"Brewmaster",19,17,36,0.527777777777778,0.461538461538462
36,"Necrophos",79,"Shadow Demon",24,21,45,0.533333333333333,0.576923076923077
36,"Necrophos",80,"Lone Druid",19,24,43,0.441860465116279,0.551282051282051
36,"Necrophos",81,"Chaos Knight",73,55,128,0.5703125,1.64102564102564
36,"Necrophos",82,"Meepo",30,32,62,0.483870967741935,0.794871794871795
36,"Necrophos",83,"Treant Protector",39,38,77,0.506493506493506,0.987179487179487
36,"Necrophos",84,"Ogre Magi",82,73,155,0.529032258064516,1.98717948717949
36,"Necrophos",85,"Undying",206,114,320,0.64375,4.1025641025641
36,"Necrophos",86,"Rubick",154,127,281,0.548042704626335,3.6025641025641
36,"Necrophos",87,"Disruptor",90,73,163,0.552147239263804,2.08974358974359
36,"Necrophos",88,"Nyx Assassin",66,34,100,0.66,1.28205128205128
36,"Necrophos",89,"Naga Siren",15,18,33,0.454545454545455,0.423076923076923
36,"Necrophos",90,"Keeper of the Light",44,31,75,0.586666666666667,0.961538461538462
36,"Necrophos",91,"Io",33,31,64,0.515625,0.82051282051282
36,"Necrophos",92,"Visage",18,16,34,0.529411764705882,0.435897435897436
36,"Necrophos",93,"Slark",192,163,355,0.540845070422535,4.55128205128205
36,"Necrophos",94,"Medusa",72,46,118,0.610169491525424,1.51282051282051
36,"Necrophos",95,"Troll Warlord",45,30,75,0.6,0.961538461538462
36,"Necrophos",96,"Centaur Warrunner",52,32,84,0.619047619047619,1.07692307692308
36,"Necrophos",97,"Magnus",49,54,103,0.475728155339806,1.32051282051282
36,"Necrophos",98,"Timbersaw",52,53,105,0.495238095238095,1.34615384615385
36,"Necrophos",99,"Bristleback",104,88,192,0.541666666666667,2.46153846153846
36,"Necrophos",100,"Tusk",222,165,387,0.573643410852713,4.96153846153846
36,"Necrophos",101,"Skywrath Mage",31,53,84,0.369047619047619,1.07692307692308
36,"Necrophos",102,"Abaddon",110,53,163,0.674846625766871,2.08974358974359
36,"Necrophos",103,"Elder Titan",27,13,40,0.675,0.512820512820513
36,"Necrophos",104,"Legion Commander",209,198,407,0.513513513513513,5.21794871794872
36,"Necrophos",105,"Techies",20,26,46,0.434782608695652,0.58974358974359
36,"Necrophos",106,"Ember Spirit",178,149,327,0.54434250764526,4.19230769230769
36,"Necrophos",107,"Earth Spirit",57,49,106,0.537735849056604,1.35897435897436
36,"Necrophos",109,"Terrorblade",34,27,61,0.557377049180328,0.782051282051282
36,"Necrophos",110,"Phoenix",63,47,110,0.572727272727273,1.41025641025641
36,"Necrophos",111,"Oracle",15,28,43,0.348837209302326,0.551282051282051
36,"Necrophos",112,"Winter Wyvern",164,104,268,0.611940298507463,3.43589743589744
37,"Warlock",38,"Beastmaster",15,10,25,0.6,0.320512820512821
37,"Warlock",39,"Queen of Pain",62,85,147,0.421768707482993,1.88461538461538
37,"Warlock",40,"Venomancer",14,13,27,0.518518518518518,0.346153846153846
37,"Warlock",41,"Faceless Void",20,25,45,0.444444444444444,0.576923076923077
37,"Warlock",42,"Wraith King",69,48,117,0.58974358974359,1.5
37,"Warlock",43,"Death Prophet",8,13,21,0.380952380952381,0.269230769230769
37,"Warlock",44,"Phantom Assassin",66,62,128,0.515625,1.64102564102564
37,"Warlock",45,"Pugna",9,6,15,0.6,0.192307692307692
37,"Warlock",46,"Templar Assassin",37,51,88,0.420454545454545,1.12820512820513
37,"Warlock",47,"Viper",37,35,72,0.513888888888889,0.923076923076923
37,"Warlock",48,"Luna",20,10,30,0.666666666666667,0.384615384615385
37,"Warlock",49,"Dragon Knight",20,15,35,0.571428571428571,0.448717948717949
37,"Warlock",50,"Dazzle",43,29,72,0.597222222222222,0.923076923076923
37,"Warlock",51,"Clockwerk",35,33,68,0.514705882352941,0.871794871794872
37,"Warlock",52,"Leshrac",3,9,12,0.25,0.153846153846154
37,"Warlock",53,"Nature's Prophet",17,27,44,0.386363636363636,0.564102564102564
37,"Warlock",54,"Lifestealer",11,14,25,0.44,0.320512820512821
37,"Warlock",55,"Dark Seer",32,26,58,0.551724137931034,0.743589743589744
37,"Warlock",56,"Clinkz",22,16,38,0.578947368421053,0.487179487179487
37,"Warlock",57,"Omniknight",21,23,44,0.477272727272727,0.564102564102564
37,"Warlock",58,"Enchantress",4,6,10,0.4,0.128205128205128
37,"Warlock",59,"Huskar",49,23,72,0.680555555555556,0.923076923076923
37,"Warlock",60,"Night Stalker",33,20,53,0.622641509433962,0.67948717948718
37,"Warlock",61,"Broodmother",7,12,19,0.368421052631579,0.243589743589744
37,"Warlock",62,"Bounty Hunter",41,45,86,0.476744186046512,1.1025641025641
37,"Warlock",63,"Weaver",18,16,34,0.529411764705882,0.435897435897436
37,"Warlock",64,"Jakiro",10,10,20,0.5,0.256410256410256
37,"Warlock",65,"Batrider",5,8,13,0.384615384615385,0.166666666666667
37,"Warlock",66,"Chen",0,5,5,0,0.0641025641025641
37,"Warlock",67,"Spectre",73,41,114,0.640350877192982,1.46153846153846
37,"Warlock",68,"Ancient Apparition",30,23,53,0.566037735849057,0.67948717948718
37,"Warlock",69,"Doom",68,38,106,0.641509433962264,1.35897435897436
37,"Warlock",70,"Ursa",44,20,64,0.6875,0.82051282051282
37,"Warlock",71,"Spirit Breaker",61,43,104,0.586538461538462,1.33333333333333
37,"Warlock",72,"Gyrocopter",47,46,93,0.505376344086022,1.19230769230769
37,"Warlock",73,"Alchemist",80,71,151,0.529801324503311,1.93589743589744
37,"Warlock",74,"Invoker",77,64,141,0.546099290780142,1.80769230769231
37,"Warlock",75,"Silencer",33,30,63,0.523809523809524,0.807692307692308
37,"Warlock",76,"Outworld Devourer",12,10,22,0.545454545454545,0.282051282051282
37,"Warlock",77,"Lycan",11,5,16,0.6875,0.205128205128205
37,"Warlock",78,"Brewmaster",14,7,21,0.666666666666667,0.269230769230769
37,"Warlock",79,"Shadow Demon",3,7,10,0.3,0.128205128205128
37,"Warlock",80,"Lone Druid",5,7,12,0.416666666666667,0.153846153846154
37,"Warlock",81,"Chaos Knight",22,21,43,0.511627906976744,0.551282051282051
37,"Warlock",82,"Meepo",9,16,25,0.36,0.320512820512821
37,"Warlock",83,"Treant Protector",13,8,21,0.619047619047619,0.269230769230769
37,"Warlock",84,"Ogre Magi",22,16,38,0.578947368421053,0.487179487179487
37,"Warlock",85,"Undying",44,39,83,0.530120481927711,1.06410256410256
37,"Warlock",86,"Rubick",26,39,65,0.4,0.833333333333333
37,"Warlock",87,"Disruptor",25,15,40,0.625,0.512820512820513
37,"Warlock",88,"Nyx Assassin",20,18,38,0.526315789473684,0.487179487179487
37,"Warlock",89,"Naga Siren",5,8,13,0.384615384615385,0.166666666666667
37,"Warlock",90,"Keeper of the Light",8,7,15,0.533333333333333,0.192307692307692
37,"Warlock",91,"Io",5,7,12,0.416666666666667,0.153846153846154
37,"Warlock",92,"Visage",4,4,8,0.5,0.102564102564103
37,"Warlock",93,"Slark",58,59,117,0.495726495726496,1.5
37,"Warlock",94,"Medusa",26,17,43,0.604651162790698,0.551282051282051
37,"Warlock",95,"Troll Warlord",13,16,29,0.448275862068966,0.371794871794872
37,"Warlock",96,"Centaur Warrunner",11,9,20,0.55,0.256410256410256
37,"Warlock",97,"Magnus",18,27,45,0.4,0.576923076923077
37,"Warlock",98,"Timbersaw",20,16,36,0.555555555555556,0.461538461538462
37,"Warlock",99,"Bristleback",34,30,64,0.53125,0.82051282051282
37,"Warlock",100,"Tusk",77,51,128,0.6015625,1.64102564102564
37,"Warlock",101,"Skywrath Mage",8,8,16,0.5,0.205128205128205
37,"Warlock",102,"Abaddon",26,11,37,0.702702702702703,0.474358974358974
37,"Warlock",103,"Elder Titan",6,3,9,0.666666666666667,0.115384615384615
37,"Warlock",104,"Legion Commander",60,54,114,0.526315789473684,1.46153846153846
37,"Warlock",105,"Techies",4,12,16,0.25,0.205128205128205
37,"Warlock",106,"Ember Spirit",58,59,117,0.495726495726496,1.5
37,"Warlock",107,"Earth Spirit",10,19,29,0.344827586206897,0.371794871794872
37,"Warlock",109,"Terrorblade",9,15,24,0.375,0.307692307692308
37,"Warlock",110,"Phoenix",18,14,32,0.5625,0.41025641025641
37,"Warlock",111,"Oracle",4,6,10,0.4,0.128205128205128
37,"Warlock",112,"Winter Wyvern",26,29,55,0.472727272727273,0.705128205128205
38,"Beastmaster",39,"Queen of Pain",56,41,97,0.577319587628866,1.24358974358974
38,"Beastmaster",40,"Venomancer",16,9,25,0.64,0.320512820512821
38,"Beastmaster",41,"Faceless Void",10,16,26,0.384615384615385,0.333333333333333
38,"Beastmaster",42,"Wraith King",41,35,76,0.539473684210526,0.974358974358974
38,"Beastmaster",43,"Death Prophet",4,7,11,0.363636363636364,0.141025641025641
38,"Beastmaster",44,"Phantom Assassin",28,33,61,0.459016393442623,0.782051282051282
38,"Beastmaster",45,"Pugna",9,13,22,0.409090909090909,0.282051282051282
38,"Beastmaster",46,"Templar Assassin",29,30,59,0.491525423728814,0.756410256410256
38,"Beastmaster",47,"Viper",12,13,25,0.48,0.320512820512821
38,"Beastmaster",48,"Luna",15,14,29,0.517241379310345,0.371794871794872
38,"Beastmaster",49,"Dragon Knight",15,8,23,0.652173913043478,0.294871794871795
38,"Beastmaster",50,"Dazzle",51,42,93,0.548387096774194,1.19230769230769
38,"Beastmaster",51,"Clockwerk",9,8,17,0.529411764705882,0.217948717948718
38,"Beastmaster",52,"Leshrac",5,4,9,0.555555555555556,0.115384615384615
38,"Beastmaster",53,"Nature's Prophet",16,20,36,0.444444444444444,0.461538461538462
38,"Beastmaster",54,"Lifestealer",14,11,25,0.56,0.320512820512821
38,"Beastmaster",55,"Dark Seer",7,6,13,0.538461538461538,0.166666666666667
38,"Beastmaster",56,"Clinkz",8,12,20,0.4,0.256410256410256
38,"Beastmaster",57,"Omniknight",28,10,38,0.736842105263158,0.487179487179487
38,"Beastmaster",58,"Enchantress",1,8,9,0.111111111111111,0.115384615384615
38,"Beastmaster",59,"Huskar",18,15,33,0.545454545454545,0.423076923076923
38,"Beastmaster",60,"Night Stalker",12,11,23,0.521739130434783,0.294871794871795
38,"Beastmaster",61,"Broodmother",3,4,7,0.428571428571429,0.0897435897435897
38,"Beastmaster",62,"Bounty Hunter",31,37,68,0.455882352941176,0.871794871794872
38,"Beastmaster",63,"Weaver",13,13,26,0.5,0.333333333333333
38,"Beastmaster",64,"Jakiro",20,14,34,0.588235294117647,0.435897435897436
38,"Beastmaster",65,"Batrider",1,2,3,0.333333333333333,0.0384615384615385
38,"Beastmaster",66,"Chen",4,4,8,0.5,0.102564102564103
38,"Beastmaster",67,"Spectre",40,27,67,0.597014925373134,0.858974358974359
38,"Beastmaster",68,"Ancient Apparition",41,36,77,0.532467532467532,0.987179487179487
38,"Beastmaster",69,"Doom",17,29,46,0.369565217391304,0.58974358974359
38,"Beastmaster",70,"Ursa",29,11,40,0.725,0.512820512820513
38,"Beastmaster",71,"Spirit Breaker",25,22,47,0.531914893617021,0.602564102564103
38,"Beastmaster",72,"Gyrocopter",46,28,74,0.621621621621622,0.948717948717949
38,"Beastmaster",73,"Alchemist",60,25,85,0.705882352941177,1.08974358974359
38,"Beastmaster",74,"Invoker",56,60,116,0.482758620689655,1.48717948717949
38,"Beastmaster",75,"Silencer",35,31,66,0.53030303030303,0.846153846153846
38,"Beastmaster",76,"Outworld Devourer",3,4,7,0.428571428571429,0.0897435897435897
38,"Beastmaster",77,"Lycan",9,11,20,0.45,0.256410256410256
38,"Beastmaster",78,"Brewmaster",7,5,12,0.583333333333333,0.153846153846154
38,"Beastmaster",79,"Shadow Demon",4,6,10,0.4,0.128205128205128
38,"Beastmaster",80,"Lone Druid",5,4,9,0.555555555555556,0.115384615384615
38,"Beastmaster",81,"Chaos Knight",9,14,23,0.391304347826087,0.294871794871795
38,"Beastmaster",82,"Meepo",8,6,14,0.571428571428571,0.179487179487179
38,"Beastmaster",83,"Treant Protector",8,8,16,0.5,0.205128205128205
38,"Beastmaster",84,"Ogre Magi",17,18,35,0.485714285714286,0.448717948717949
38,"Beastmaster",85,"Undying",21,14,35,0.6,0.448717948717949
38,"Beastmaster",86,"Rubick",39,43,82,0.475609756097561,1.05128205128205
38,"Beastmaster",87,"Disruptor",22,22,44,0.5,0.564102564102564
38,"Beastmaster",88,"Nyx Assassin",5,7,12,0.416666666666667,0.153846153846154
38,"Beastmaster",89,"Naga Siren",7,3,10,0.7,0.128205128205128
38,"Beastmaster",90,"Keeper of the Light",11,6,17,0.647058823529412,0.217948717948718
38,"Beastmaster",91,"Io",10,7,17,0.588235294117647,0.217948717948718
38,"Beastmaster",92,"Visage",9,2,11,0.818181818181818,0.141025641025641
38,"Beastmaster",93,"Slark",40,51,91,0.43956043956044,1.16666666666667
38,"Beastmaster",94,"Medusa",10,10,20,0.5,0.256410256410256
38,"Beastmaster",95,"Troll Warlord",8,10,18,0.444444444444444,0.230769230769231
38,"Beastmaster",96,"Centaur Warrunner",6,3,9,0.666666666666667,0.115384615384615
38,"Beastmaster",97,"Magnus",9,12,21,0.428571428571429,0.269230769230769
38,"Beastmaster",98,"Timbersaw",8,14,22,0.363636363636364,0.282051282051282
38,"Beastmaster",99,"Bristleback",14,15,29,0.482758620689655,0.371794871794872
38,"Beastmaster",100,"Tusk",46,38,84,0.547619047619048,1.07692307692308
38,"Beastmaster",101,"Skywrath Mage",13,20,33,0.393939393939394,0.423076923076923
38,"Beastmaster",102,"Abaddon",15,10,25,0.6,0.320512820512821
38,"Beastmaster",103,"Elder Titan",1,2,3,0.333333333333333,0.0384615384615385
38,"Beastmaster",104,"Legion Commander",32,29,61,0.524590163934426,0.782051282051282
38,"Beastmaster",105,"Techies",8,5,13,0.615384615384615,0.166666666666667
38,"Beastmaster",106,"Ember Spirit",28,32,60,0.466666666666667,0.769230769230769
38,"Beastmaster",107,"Earth Spirit",11,10,21,0.523809523809524,0.269230769230769
38,"Beastmaster",109,"Terrorblade",13,11,24,0.541666666666667,0.307692307692308
38,"Beastmaster",110,"Phoenix",9,6,15,0.6,0.192307692307692
38,"Beastmaster",111,"Oracle",8,7,15,0.533333333333333,0.192307692307692
38,"Beastmaster",112,"Winter Wyvern",52,40,92,0.565217391304348,1.17948717948718
39,"Queen of Pain",40,"Venomancer",111,121,232,0.478448275862069,2.97435897435897
39,"Queen of Pain",41,"Faceless Void",89,167,256,0.34765625,3.28205128205128
39,"Queen of Pain",42,"Wraith King",357,356,713,0.50070126227209,9.14102564102564
39,"Queen of Pain",43,"Death Prophet",24,30,54,0.444444444444444,0.692307692307692
39,"Queen of Pain",44,"Phantom Assassin",234,300,534,0.438202247191011,6.84615384615385
39,"Queen of Pain",45,"Pugna",36,62,98,0.36734693877551,1.25641025641026
39,"Queen of Pain",46,"Templar Assassin",90,125,215,0.418604651162791,2.75641025641026
39,"Queen of Pain",47,"Viper",77,109,186,0.413978494623656,2.38461538461538
39,"Queen of Pain",48,"Luna",76,90,166,0.457831325301205,2.12820512820513
39,"Queen of Pain",49,"Dragon Knight",52,61,113,0.460176991150442,1.44871794871795
39,"Queen of Pain",50,"Dazzle",354,415,769,0.460338101430429,9.85897435897436
39,"Queen of Pain",51,"Clockwerk",136,199,335,0.405970149253731,4.29487179487179
39,"Queen of Pain",52,"Leshrac",17,55,72,0.236111111111111,0.923076923076923
39,"Queen of Pain",53,"Nature's Prophet",100,172,272,0.367647058823529,3.48717948717949
39,"Queen of Pain",54,"Lifestealer",78,133,211,0.369668246445498,2.70512820512821
39,"Queen of Pain",55,"Dark Seer",172,186,358,0.480446927374302,4.58974358974359
39,"Queen of Pain",56,"Clinkz",77,90,167,0.461077844311377,2.14102564102564
39,"Queen of Pain",57,"Omniknight",233,188,421,0.553444180522565,5.3974358974359
39,"Queen of Pain",58,"Enchantress",17,45,62,0.274193548387097,0.794871794871795
39,"Queen of Pain",59,"Huskar",121,138,259,0.467181467181467,3.32051282051282
39,"Queen of Pain",60,"Night Stalker",100,134,234,0.427350427350427,3
39,"Queen of Pain",61,"Broodmother",39,64,103,0.378640776699029,1.32051282051282
39,"Queen of Pain",62,"Bounty Hunter",333,315,648,0.513888888888889,8.30769230769231
39,"Queen of Pain",63,"Weaver",64,106,170,0.376470588235294,2.17948717948718
39,"Queen of Pain",64,"Jakiro",113,139,252,0.448412698412698,3.23076923076923
39,"Queen of Pain",65,"Batrider",24,49,73,0.328767123287671,0.935897435897436
39,"Queen of Pain",66,"Chen",27,30,57,0.473684210526316,0.730769230769231
39,"Queen of Pain",67,"Spectre",316,264,580,0.544827586206897,7.43589743589744
39,"Queen of Pain",68,"Ancient Apparition",285,340,625,0.456,8.01282051282051
39,"Queen of Pain",69,"Doom",335,350,685,0.489051094890511,8.78205128205128
39,"Queen of Pain",70,"Ursa",174,172,346,0.502890173410405,4.43589743589744
39,"Queen of Pain",71,"Spirit Breaker",346,350,696,0.497126436781609,8.92307692307692
39,"Queen of Pain",72,"Gyrocopter",271,319,590,0.459322033898305,7.56410256410256
39,"Queen of Pain",73,"Alchemist",242,310,552,0.438405797101449,7.07692307692308
39,"Queen of Pain",74,"Invoker",182,234,416,0.4375,5.33333333333333
39,"Queen of Pain",75,"Silencer",226,279,505,0.447524752475248,6.47435897435897
39,"Queen of Pain",76,"Outworld Devourer",24,46,70,0.342857142857143,0.897435897435897
39,"Queen of Pain",77,"Lycan",38,43,81,0.469135802469136,1.03846153846154
39,"Queen of Pain",78,"Brewmaster",24,33,57,0.421052631578947,0.730769230769231
39,"Queen of Pain",79,"Shadow Demon",46,76,122,0.377049180327869,1.56410256410256
39,"Queen of Pain",80,"Lone Druid",33,35,68,0.485294117647059,0.871794871794872
39,"Queen of Pain",81,"Chaos Knight",66,119,185,0.356756756756757,2.37179487179487
39,"Queen of Pain",82,"Meepo",41,58,99,0.414141414141414,1.26923076923077
39,"Queen of Pain",83,"Treant Protector",80,63,143,0.559440559440559,1.83333333333333
39,"Queen of Pain",84,"Ogre Magi",158,234,392,0.403061224489796,5.02564102564103
39,"Queen of Pain",85,"Undying",310,246,556,0.557553956834532,7.12820512820513
39,"Queen of Pain",86,"Rubick",289,441,730,0.395890410958904,9.35897435897436
39,"Queen of Pain",87,"Disruptor",213,213,426,0.5,5.46153846153846
39,"Queen of Pain",88,"Nyx Assassin",89,117,206,0.432038834951456,2.64102564102564
39,"Queen of Pain",89,"Naga Siren",32,45,77,0.415584415584416,0.987179487179487
39,"Queen of Pain",90,"Keeper of the Light",61,92,153,0.398692810457516,1.96153846153846
39,"Queen of Pain",91,"Io",54,90,144,0.375,1.84615384615385
39,"Queen of Pain",92,"Visage",40,54,94,0.425531914893617,1.20512820512821
39,"Queen of Pain",93,"Slark",326,406,732,0.445355191256831,9.38461538461539
39,"Queen of Pain",94,"Medusa",68,83,151,0.450331125827815,1.93589743589744
39,"Queen of Pain",95,"Troll Warlord",46,56,102,0.450980392156863,1.30769230769231
39,"Queen of Pain",96,"Centaur Warrunner",62,90,152,0.407894736842105,1.94871794871795
39,"Queen of Pain",97,"Magnus",86,156,242,0.355371900826446,3.1025641025641
39,"Queen of Pain",98,"Timbersaw",90,133,223,0.403587443946188,2.85897435897436
39,"Queen of Pain",99,"Bristleback",118,187,305,0.386885245901639,3.91025641025641
39,"Queen of Pain",100,"Tusk",410,498,908,0.451541850220264,11.6410256410256
39,"Queen of Pain",101,"Skywrath Mage",81,131,212,0.382075471698113,2.71794871794872
39,"Queen of Pain",102,"Abaddon",134,126,260,0.515384615384615,3.33333333333333
39,"Queen of Pain",103,"Elder Titan",35,26,61,0.573770491803279,0.782051282051282
39,"Queen of Pain",104,"Legion Commander",271,420,691,0.392185238784371,8.85897435897436
39,"Queen of Pain",105,"Techies",28,56,84,0.333333333333333,1.07692307692308
39,"Queen of Pain",106,"Ember Spirit",183,270,453,0.403973509933775,5.80769230769231
39,"Queen of Pain",107,"Earth Spirit",126,138,264,0.477272727272727,3.38461538461538
39,"Queen of Pain",109,"Terrorblade",73,61,134,0.544776119402985,1.71794871794872
39,"Queen of Pain",110,"Phoenix",96,120,216,0.444444444444444,2.76923076923077
39,"Queen of Pain",111,"Oracle",19,48,67,0.283582089552239,0.858974358974359
39,"Queen of Pain",112,"Winter Wyvern",321,440,761,0.421813403416557,9.75641025641026
40,"Venomancer",41,"Faceless Void",30,56,86,0.348837209302326,1.1025641025641
40,"Venomancer",42,"Wraith King",111,59,170,0.652941176470588,2.17948717948718
40,"Venomancer",43,"Death Prophet",26,18,44,0.590909090909091,0.564102564102564
40,"Venomancer",44,"Phantom Assassin",91,106,197,0.461928934010152,2.52564102564103
40,"Venomancer",45,"Pugna",18,14,32,0.5625,0.41025641025641
40,"Venomancer",46,"Templar Assassin",62,56,118,0.525423728813559,1.51282051282051
40,"Venomancer",47,"Viper",64,51,115,0.556521739130435,1.47435897435897
40,"Venomancer",48,"Luna",28,22,50,0.56,0.641025641025641
40,"Venomancer",49,"Dragon Knight",24,32,56,0.428571428571429,0.717948717948718
40,"Venomancer",50,"Dazzle",73,56,129,0.565891472868217,1.65384615384615
40,"Venomancer",51,"Clockwerk",52,41,93,0.559139784946237,1.19230769230769
40,"Venomancer",52,"Leshrac",12,12,24,0.5,0.307692307692308
40,"Venomancer",53,"Nature's Prophet",31,40,71,0.436619718309859,0.91025641025641
40,"Venomancer",54,"Lifestealer",32,35,67,0.477611940298507,0.858974358974359
40,"Venomancer",55,"Dark Seer",38,41,79,0.481012658227848,1.01282051282051
40,"Venomancer",56,"Clinkz",28,15,43,0.651162790697674,0.551282051282051
40,"Venomancer",57,"Omniknight",52,32,84,0.619047619047619,1.07692307692308
40,"Venomancer",58,"Enchantress",10,10,20,0.5,0.256410256410256
40,"Venomancer",59,"Huskar",29,42,71,0.408450704225352,0.91025641025641
40,"Venomancer",60,"Night Stalker",27,26,53,0.509433962264151,0.67948717948718
40,"Venomancer",61,"Broodmother",11,20,31,0.354838709677419,0.397435897435897
40,"Venomancer",62,"Bounty Hunter",47,56,103,0.456310679611651,1.32051282051282
40,"Venomancer",63,"Weaver",25,26,51,0.490196078431373,0.653846153846154
40,"Venomancer",64,"Jakiro",28,25,53,0.528301886792453,0.67948717948718
40,"Venomancer",65,"Batrider",8,9,17,0.470588235294118,0.217948717948718
40,"Venomancer",66,"Chen",7,10,17,0.411764705882353,0.217948717948718
40,"Venomancer",67,"Spectre",97,70,167,0.580838323353293,2.14102564102564
40,"Venomancer",68,"Ancient Apparition",67,66,133,0.503759398496241,1.70512820512821
40,"Venomancer",69,"Doom",94,67,161,0.583850931677019,2.06410256410256
40,"Venomancer",70,"Ursa",64,34,98,0.653061224489796,1.25641025641026
40,"Venomancer",71,"Spirit Breaker",89,59,148,0.601351351351351,1.8974358974359
40,"Venomancer",72,"Gyrocopter",83,94,177,0.468926553672316,2.26923076923077
40,"Venomancer",73,"Alchemist",114,109,223,0.511210762331839,2.85897435897436
40,"Venomancer",74,"Invoker",118,144,262,0.450381679389313,3.35897435897436
40,"Venomancer",75,"Silencer",80,55,135,0.592592592592593,1.73076923076923
40,"Venomancer",76,"Outworld Devourer",22,18,40,0.55,0.512820512820513
40,"Venomancer",77,"Lycan",8,17,25,0.32,0.320512820512821
40,"Venomancer",78,"Brewmaster",16,8,24,0.666666666666667,0.307692307692308
40,"Venomancer",79,"Shadow Demon",6,14,20,0.3,0.256410256410256
40,"Venomancer",80,"Lone Druid",8,9,17,0.470588235294118,0.217948717948718
40,"Venomancer",81,"Chaos Knight",32,30,62,0.516129032258065,0.794871794871795
40,"Venomancer",82,"Meepo",21,15,36,0.583333333333333,0.461538461538462
40,"Venomancer",83,"Treant Protector",21,14,35,0.6,0.448717948717949
40,"Venomancer",84,"Ogre Magi",40,37,77,0.519480519480519,0.987179487179487
40,"Venomancer",85,"Undying",113,68,181,0.624309392265193,2.32051282051282
40,"Venomancer",86,"Rubick",55,61,116,0.474137931034483,1.48717948717949
40,"Venomancer",87,"Disruptor",39,20,59,0.661016949152542,0.756410256410256
40,"Venomancer",88,"Nyx Assassin",25,18,43,0.581395348837209,0.551282051282051
40,"Venomancer",89,"Naga Siren",7,14,21,0.333333333333333,0.269230769230769
40,"Venomancer",90,"Keeper of the Light",16,21,37,0.432432432432432,0.474358974358974
40,"Venomancer",91,"Io",8,8,16,0.5,0.205128205128205
40,"Venomancer",92,"Visage",11,12,23,0.478260869565217,0.294871794871795
40,"Venomancer",93,"Slark",105,89,194,0.541237113402062,2.48717948717949
40,"Venomancer",94,"Medusa",28,19,47,0.595744680851064,0.602564102564103
40,"Venomancer",95,"Troll Warlord",19,11,30,0.633333333333333,0.384615384615385
40,"Venomancer",96,"Centaur Warrunner",18,21,39,0.461538461538462,0.5
40,"Venomancer",97,"Magnus",30,42,72,0.416666666666667,0.923076923076923
40,"Venomancer",98,"Timbersaw",32,29,61,0.524590163934426,0.782051282051282
40,"Venomancer",99,"Bristleback",42,38,80,0.525,1.02564102564103
40,"Venomancer",100,"Tusk",92,83,175,0.525714285714286,2.24358974358974
40,"Venomancer",101,"Skywrath Mage",26,30,56,0.464285714285714,0.717948717948718
40,"Venomancer",102,"Abaddon",50,23,73,0.684931506849315,0.935897435897436
40,"Venomancer",103,"Elder Titan",12,7,19,0.631578947368421,0.243589743589744
40,"Venomancer",104,"Legion Commander",92,101,193,0.476683937823834,2.47435897435897
40,"Venomancer",105,"Techies",6,7,13,0.461538461538462,0.166666666666667
40,"Venomancer",106,"Ember Spirit",77,74,151,0.509933774834437,1.93589743589744
40,"Venomancer",107,"Earth Spirit",30,22,52,0.576923076923077,0.666666666666667
40,"Venomancer",109,"Terrorblade",22,24,46,0.478260869565217,0.58974358974359
40,"Venomancer",110,"Phoenix",41,23,64,0.640625,0.82051282051282
40,"Venomancer",111,"Oracle",6,7,13,0.461538461538462,0.166666666666667
40,"Venomancer",112,"Winter Wyvern",61,47,108,0.564814814814815,1.38461538461538
41,"Faceless Void",42,"Wraith King",45,42,87,0.517241379310345,1.11538461538462
41,"Faceless Void",43,"Death Prophet",19,18,37,0.513513513513513,0.474358974358974
41,"Faceless Void",44,"Phantom Assassin",25,38,63,0.396825396825397,0.807692307692308
41,"Faceless Void",45,"Pugna",18,18,36,0.5,0.461538461538462
41,"Faceless Void",46,"Templar Assassin",53,60,113,0.469026548672566,1.44871794871795
41,"Faceless Void",47,"Viper",50,57,107,0.467289719626168,1.37179487179487
41,"Faceless Void",48,"Luna",11,15,26,0.423076923076923,0.333333333333333
41,"Faceless Void",49,"Dragon Knight",20,22,42,0.476190476190476,0.538461538461538
41,"Faceless Void",50,"Dazzle",88,92,180,0.488888888888889,2.30769230769231
41,"Faceless Void",51,"Clockwerk",44,61,105,0.419047619047619,1.34615384615385
41,"Faceless Void",52,"Leshrac",14,26,40,0.35,0.512820512820513
41,"Faceless Void",53,"Nature's Prophet",26,45,71,0.366197183098592,0.91025641025641
41,"Faceless Void",54,"Lifestealer",16,23,39,0.41025641025641,0.5
41,"Faceless Void",55,"Dark Seer",46,45,91,0.505494505494505,1.16666666666667
41,"Faceless Void",56,"Clinkz",19,23,42,0.452380952380952,0.538461538461538
41,"Faceless Void",57,"Omniknight",62,60,122,0.508196721311475,1.56410256410256
41,"Faceless Void",58,"Enchantress",11,24,35,0.314285714285714,0.448717948717949
41,"Faceless Void",59,"Huskar",25,24,49,0.510204081632653,0.628205128205128
41,"Faceless Void",60,"Night Stalker",28,33,61,0.459016393442623,0.782051282051282
41,"Faceless Void",61,"Broodmother",12,19,31,0.387096774193548,0.397435897435897
41,"Faceless Void",62,"Bounty Hunter",61,76,137,0.445255474452555,1.75641025641026
41,"Faceless Void",63,"Weaver",14,29,43,0.325581395348837,0.551282051282051
41,"Faceless Void",64,"Jakiro",52,45,97,0.536082474226804,1.24358974358974
41,"Faceless Void",65,"Batrider",12,7,19,0.631578947368421,0.243589743589744
41,"Faceless Void",66,"Chen",12,12,24,0.5,0.307692307692308
41,"Faceless Void",67,"Spectre",12,22,34,0.352941176470588,0.435897435897436
41,"Faceless Void",68,"Ancient Apparition",89,113,202,0.440594059405941,2.58974358974359
41,"Faceless Void",69,"Doom",76,74,150,0.506666666666667,1.92307692307692
41,"Faceless Void",70,"Ursa",35,34,69,0.507246376811594,0.884615384615385
41,"Faceless Void",71,"Spirit Breaker",63,72,135,0.466666666666667,1.73076923076923
41,"Faceless Void",72,"Gyrocopter",46,42,88,0.522727272727273,1.12820512820513
41,"Faceless Void",73,"Alchemist",102,97,199,0.512562814070352,2.55128205128205
41,"Faceless Void",74,"Invoker",170,192,362,0.469613259668508,4.64102564102564
41,"Faceless Void",75,"Silencer",108,94,202,0.534653465346535,2.58974358974359
41,"Faceless Void",76,"Outworld Devourer",20,29,49,0.408163265306122,0.628205128205128
41,"Faceless Void",77,"Lycan",7,13,20,0.35,0.256410256410256
41,"Faceless Void",78,"Brewmaster",12,12,24,0.5,0.307692307692308
41,"Faceless Void",79,"Shadow Demon",11,18,29,0.379310344827586,0.371794871794872
41,"Faceless Void",80,"Lone Druid",6,13,19,0.315789473684211,0.243589743589744
41,"Faceless Void",81,"Chaos Knight",13,19,32,0.40625,0.41025641025641
41,"Faceless Void",82,"Meepo",8,21,29,0.275862068965517,0.371794871794872
41,"Faceless Void",83,"Treant Protector",18,20,38,0.473684210526316,0.487179487179487
41,"Faceless Void",84,"Ogre Magi",55,58,113,0.486725663716814,1.44871794871795
41,"Faceless Void",85,"Undying",61,67,128,0.4765625,1.64102564102564
41,"Faceless Void",86,"Rubick",62,117,179,0.346368715083799,2.29487179487179
41,"Faceless Void",87,"Disruptor",48,75,123,0.390243902439024,1.57692307692308
41,"Faceless Void",88,"Nyx Assassin",29,45,74,0.391891891891892,0.948717948717949
41,"Faceless Void",89,"Naga Siren",6,16,22,0.272727272727273,0.282051282051282
41,"Faceless Void",90,"Keeper of the Light",20,27,47,0.425531914893617,0.602564102564103
41,"Faceless Void",91,"Io",10,22,32,0.3125,0.41025641025641
41,"Faceless Void",92,"Visage",6,16,22,0.272727272727273,0.282051282051282
41,"Faceless Void",93,"Slark",31,40,71,0.436619718309859,0.91025641025641
41,"Faceless Void",94,"Medusa",16,11,27,0.592592592592593,0.346153846153846
41,"Faceless Void",95,"Troll Warlord",7,11,18,0.388888888888889,0.230769230769231
41,"Faceless Void",96,"Centaur Warrunner",15,23,38,0.394736842105263,0.487179487179487
41,"Faceless Void",97,"Magnus",30,47,77,0.38961038961039,0.987179487179487
41,"Faceless Void",98,"Timbersaw",40,48,88,0.454545454545455,1.12820512820513
41,"Faceless Void",99,"Bristleback",44,53,97,0.45360824742268,1.24358974358974
41,"Faceless Void",100,"Tusk",75,112,187,0.401069518716578,2.3974358974359
41,"Faceless Void",101,"Skywrath Mage",31,79,110,0.281818181818182,1.41025641025641
41,"Faceless Void",102,"Abaddon",35,46,81,0.432098765432099,1.03846153846154
41,"Faceless Void",103,"Elder Titan",12,17,29,0.413793103448276,0.371794871794872
41,"Faceless Void",104,"Legion Commander",75,95,170,0.441176470588235,2.17948717948718
41,"Faceless Void",105,"Techies",11,20,31,0.354838709677419,0.397435897435897
41,"Faceless Void",106,"Ember Spirit",36,66,102,0.352941176470588,1.30769230769231
41,"Faceless Void",107,"Earth Spirit",24,27,51,0.470588235294118,0.653846153846154
41,"Faceless Void",109,"Terrorblade",5,14,19,0.263157894736842,0.243589743589744
41,"Faceless Void",110,"Phoenix",59,41,100,0.59,1.28205128205128
41,"Faceless Void",111,"Oracle",7,13,20,0.35,0.256410256410256
41,"Faceless Void",112,"Winter Wyvern",72,96,168,0.428571428571429,2.15384615384615
42,"Wraith King",43,"Death Prophet",48,43,91,0.527472527472527,1.16666666666667
42,"Wraith King",44,"Phantom Assassin",121,86,207,0.584541062801932,2.65384615384615
42,"Wraith King",45,"Pugna",46,41,87,0.528735632183908,1.11538461538462
42,"Wraith King",46,"Templar Assassin",223,158,381,0.585301837270341,4.88461538461539
42,"Wraith King",47,"Viper",126,78,204,0.617647058823529,2.61538461538462
42,"Wraith King",48,"Luna",39,32,71,0.549295774647887,0.91025641025641
42,"Wraith King",49,"Dragon Knight",33,24,57,0.578947368421053,0.730769230769231
42,"Wraith King",50,"Dazzle",336,234,570,0.589473684210526,7.30769230769231
42,"Wraith King",51,"Clockwerk",137,100,237,0.578059071729958,3.03846153846154
42,"Wraith King",52,"Leshrac",47,33,80,0.5875,1.02564102564103
42,"Wraith King",53,"Nature's Prophet",78,98,176,0.443181818181818,2.25641025641026
42,"Wraith King",54,"Lifestealer",49,35,84,0.583333333333333,1.07692307692308
42,"Wraith King",55,"Dark Seer",140,123,263,0.532319391634981,3.37179487179487
42,"Wraith King",56,"Clinkz",56,57,113,0.495575221238938,1.44871794871795
42,"Wraith King",57,"Omniknight",196,99,295,0.664406779661017,3.78205128205128
42,"Wraith King",58,"Enchantress",34,29,63,0.53968253968254,0.807692307692308
42,"Wraith King",59,"Huskar",86,67,153,0.562091503267974,1.96153846153846
42,"Wraith King",60,"Night Stalker",103,59,162,0.635802469135803,2.07692307692308
42,"Wraith King",61,"Broodmother",58,48,106,0.547169811320755,1.35897435897436
42,"Wraith King",62,"Bounty Hunter",234,177,411,0.569343065693431,5.26923076923077
42,"Wraith King",63,"Weaver",61,50,111,0.54954954954955,1.42307692307692
42,"Wraith King",64,"Jakiro",109,78,187,0.582887700534759,2.3974358974359
42,"Wraith King",65,"Batrider",36,30,66,0.545454545454545,0.846153846153846
42,"Wraith King",66,"Chen",22,13,35,0.628571428571429,0.448717948717949
42,"Wraith King",67,"Spectre",81,54,135,0.6,1.73076923076923
42,"Wraith King",68,"Ancient Apparition",280,195,475,0.589473684210526,6.08974358974359
42,"Wraith King",69,"Doom",280,168,448,0.625,5.74358974358974
42,"Wraith King",70,"Ursa",118,67,185,0.637837837837838,2.37179487179487
42,"Wraith King",71,"Spirit Breaker",266,148,414,0.642512077294686,5.30769230769231
42,"Wraith King",72,"Gyrocopter",99,57,156,0.634615384615385,2
42,"Wraith King",73,"Alchemist",303,163,466,0.650214592274678,5.97435897435897
42,"Wraith King",74,"Invoker",443,291,734,0.603542234332425,9.41025641025641
42,"Wraith King",75,"Silencer",283,198,481,0.588357588357588,6.16666666666667
42,"Wraith King",76,"Outworld Devourer",46,32,78,0.58974358974359,1
42,"Wraith King",77,"Lycan",20,10,30,0.666666666666667,0.384615384615385
42,"Wraith King",78,"Brewmaster",36,21,57,0.631578947368421,0.730769230769231
42,"Wraith King",79,"Shadow Demon",59,49,108,0.546296296296296,1.38461538461538
42,"Wraith King",80,"Lone Druid",29,24,53,0.547169811320755,0.67948717948718
42,"Wraith King",81,"Chaos Knight",35,24,59,0.593220338983051,0.756410256410256
42,"Wraith King",82,"Meepo",47,29,76,0.618421052631579,0.974358974358974
42,"Wraith King",83,"Treant Protector",51,40,91,0.56043956043956,1.16666666666667
42,"Wraith King",84,"Ogre Magi",160,103,263,0.608365019011407,3.37179487179487
42,"Wraith King",85,"Undying",241,135,376,0.640957446808511,4.82051282051282
42,"Wraith King",86,"Rubick",283,249,532,0.531954887218045,6.82051282051282
42,"Wraith King",87,"Disruptor",214,116,330,0.648484848484848,4.23076923076923
42,"Wraith King",88,"Nyx Assassin",87,65,152,0.572368421052632,1.94871794871795
42,"Wraith King",89,"Naga Siren",15,16,31,0.483870967741935,0.397435897435897
42,"Wraith King",90,"Keeper of the Light",78,72,150,0.52,1.92307692307692
42,"Wraith King",91,"Io",55,39,94,0.585106382978723,1.20512820512821
42,"Wraith King",92,"Visage",40,32,72,0.555555555555556,0.923076923076923
42,"Wraith King",93,"Slark",120,95,215,0.558139534883721,2.75641025641026
42,"Wraith King",94,"Medusa",47,23,70,0.671428571428571,0.897435897435897
42,"Wraith King",95,"Troll Warlord",42,27,69,0.608695652173913,0.884615384615385
42,"Wraith King",96,"Centaur Warrunner",61,34,95,0.642105263157895,1.21794871794872
42,"Wraith King",97,"Magnus",111,83,194,0.572164948453608,2.48717948717949
42,"Wraith King",98,"Timbersaw",87,72,159,0.547169811320755,2.03846153846154
42,"Wraith King",99,"Bristleback",108,84,192,0.5625,2.46153846153846
42,"Wraith King",100,"Tusk",385,235,620,0.620967741935484,7.94871794871795
42,"Wraith King",101,"Skywrath Mage",91,87,178,0.51123595505618,2.28205128205128
42,"Wraith King",102,"Abaddon",116,54,170,0.682352941176471,2.17948717948718
42,"Wraith King",103,"Elder Titan",33,11,44,0.75,0.564102564102564
42,"Wraith King",104,"Legion Commander",221,166,387,0.571059431524548,4.96153846153846
42,"Wraith King",105,"Techies",33,27,60,0.55,0.769230769230769
42,"Wraith King",106,"Ember Spirit",201,128,329,0.610942249240122,4.21794871794872
42,"Wraith King",107,"Earth Spirit",122,61,183,0.666666666666667,2.34615384615385
42,"Wraith King",109,"Terrorblade",38,20,58,0.655172413793103,0.743589743589744
42,"Wraith King",110,"Phoenix",123,89,212,0.580188679245283,2.71794871794872
42,"Wraith King",111,"Oracle",45,40,85,0.529411764705882,1.08974358974359
42,"Wraith King",112,"Winter Wyvern",291,229,520,0.559615384615385,6.66666666666667
43,"Death Prophet",44,"Phantom Assassin",65,52,117,0.555555555555556,1.5
43,"Death Prophet",45,"Pugna",8,11,19,0.421052631578947,0.243589743589744
43,"Death Prophet",46,"Templar Assassin",20,19,39,0.512820512820513,0.5
43,"Death Prophet",47,"Viper",18,11,29,0.620689655172414,0.371794871794872
43,"Death Prophet",48,"Luna",16,17,33,0.484848484848485,0.423076923076923
43,"Death Prophet",49,"Dragon Knight",14,16,30,0.466666666666667,0.384615384615385
43,"Death Prophet",50,"Dazzle",56,48,104,0.538461538461538,1.33333333333333
43,"Death Prophet",51,"Clockwerk",23,19,42,0.547619047619048,0.538461538461538
43,"Death Prophet",52,"Leshrac",7,5,12,0.583333333333333,0.153846153846154
43,"Death Prophet",53,"Nature's Prophet",20,33,53,0.377358490566038,0.67948717948718
43,"Death Prophet",54,"Lifestealer",18,24,42,0.428571428571429,0.538461538461538
43,"Death Prophet",55,"Dark Seer",18,28,46,0.391304347826087,0.58974358974359
43,"Death Prophet",56,"Clinkz",12,14,26,0.461538461538462,0.333333333333333
43,"Death Prophet",57,"Omniknight",51,24,75,0.68,0.961538461538462
43,"Death Prophet",58,"Enchantress",1,4,5,0.2,0.0641025641025641
43,"Death Prophet",59,"Huskar",22,21,43,0.511627906976744,0.551282051282051
43,"Death Prophet",60,"Night Stalker",27,18,45,0.6,0.576923076923077
43,"Death Prophet",61,"Broodmother",5,9,14,0.357142857142857,0.179487179487179
43,"Death Prophet",62,"Bounty Hunter",41,46,87,0.471264367816092,1.11538461538462
43,"Death Prophet",63,"Weaver",16,19,35,0.457142857142857,0.448717948717949
43,"Death Prophet",64,"Jakiro",19,18,37,0.513513513513513,0.474358974358974
43,"Death Prophet",65,"Batrider",4,9,13,0.307692307692308,0.166666666666667
43,"Death Prophet",66,"Chen",7,5,12,0.583333333333333,0.153846153846154
43,"Death Prophet",67,"Spectre",42,26,68,0.617647058823529,0.871794871794872
43,"Death Prophet",68,"Ancient Apparition",38,37,75,0.506666666666667,0.961538461538462
43,"Death Prophet",69,"Doom",44,42,86,0.511627906976744,1.1025641025641
43,"Death Prophet",70,"Ursa",45,42,87,0.517241379310345,1.11538461538462
43,"Death Prophet",71,"Spirit Breaker",43,41,84,0.511904761904762,1.07692307692308
43,"Death Prophet",72,"Gyrocopter",43,41,84,0.511904761904762,1.07692307692308
43,"Death Prophet",73,"Alchemist",44,55,99,0.444444444444444,1.26923076923077
43,"Death Prophet",74,"Invoker",44,54,98,0.448979591836735,1.25641025641026
43,"Death Prophet",75,"Silencer",39,33,72,0.541666666666667,0.923076923076923
43,"Death Prophet",76,"Outworld Devourer",5,4,9,0.555555555555556,0.115384615384615
43,"Death Prophet",77,"Lycan",20,7,27,0.740740740740741,0.346153846153846
43,"Death Prophet",78,"Brewmaster",3,11,14,0.214285714285714,0.179487179487179
43,"Death Prophet",79,"Shadow Demon",6,8,14,0.428571428571429,0.179487179487179
43,"Death Prophet",80,"Lone Druid",3,8,11,0.272727272727273,0.141025641025641
43,"Death Prophet",81,"Chaos Knight",24,11,35,0.685714285714286,0.448717948717949
43,"Death Prophet",82,"Meepo",10,2,12,0.833333333333333,0.153846153846154
43,"Death Prophet",83,"Treant Protector",18,16,34,0.529411764705882,0.435897435897436
43,"Death Prophet",84,"Ogre Magi",34,29,63,0.53968253968254,0.807692307692308
43,"Death Prophet",85,"Undying",50,42,92,0.543478260869565,1.17948717948718
43,"Death Prophet",86,"Rubick",34,51,85,0.4,1.08974358974359
43,"Death Prophet",87,"Disruptor",30,16,46,0.652173913043478,0.58974358974359
43,"Death Prophet",88,"Nyx Assassin",25,22,47,0.531914893617021,0.602564102564103
43,"Death Prophet",89,"Naga Siren",3,7,10,0.3,0.128205128205128
43,"Death Prophet",90,"Keeper of the Light",18,20,38,0.473684210526316,0.487179487179487
43,"Death Prophet",91,"Io",6,6,12,0.5,0.153846153846154
43,"Death Prophet",92,"Visage",7,7,14,0.5,0.179487179487179
43,"Death Prophet",93,"Slark",41,57,98,0.418367346938776,1.25641025641026
43,"Death Prophet",94,"Medusa",17,22,39,0.435897435897436,0.5
43,"Death Prophet",95,"Troll Warlord",15,8,23,0.652173913043478,0.294871794871795
43,"Death Prophet",96,"Centaur Warrunner",14,17,31,0.451612903225806,0.397435897435897
43,"Death Prophet",97,"Magnus",19,20,39,0.487179487179487,0.5
43,"Death Prophet",98,"Timbersaw",16,22,38,0.421052631578947,0.487179487179487
43,"Death Prophet",99,"Bristleback",27,38,65,0.415384615384615,0.833333333333333
43,"Death Prophet",100,"Tusk",58,57,115,0.504347826086956,1.47435897435897
43,"Death Prophet",101,"Skywrath Mage",11,18,29,0.379310344827586,0.371794871794872
43,"Death Prophet",102,"Abaddon",26,15,41,0.634146341463415,0.525641025641026
43,"Death Prophet",103,"Elder Titan",6,2,8,0.75,0.102564102564103
43,"Death Prophet",104,"Legion Commander",61,61,122,0.5,1.56410256410256
43,"Death Prophet",105,"Techies",2,15,17,0.117647058823529,0.217948717948718
43,"Death Prophet",106,"Ember Spirit",30,44,74,0.405405405405405,0.948717948717949
43,"Death Prophet",107,"Earth Spirit",6,14,20,0.3,0.256410256410256
43,"Death Prophet",109,"Terrorblade",7,7,14,0.5,0.179487179487179
43,"Death Prophet",110,"Phoenix",14,14,28,0.5,0.358974358974359
43,"Death Prophet",111,"Oracle",5,6,11,0.454545454545455,0.141025641025641
43,"Death Prophet",112,"Winter Wyvern",55,42,97,0.56701030927835,1.24358974358974
44,"Phantom Assassin",45,"Pugna",56,45,101,0.554455445544555,1.29487179487179
44,"Phantom Assassin",46,"Templar Assassin",142,164,306,0.464052287581699,3.92307692307692
44,"Phantom Assassin",47,"Viper",71,107,178,0.398876404494382,2.28205128205128
44,"Phantom Assassin",48,"Luna",22,26,48,0.458333333333333,0.615384615384615
44,"Phantom Assassin",49,"Dragon Knight",42,53,95,0.442105263157895,1.21794871794872
44,"Phantom Assassin",50,"Dazzle",246,256,502,0.49003984063745,6.43589743589744
44,"Phantom Assassin",51,"Clockwerk",123,130,253,0.486166007905138,3.24358974358974
44,"Phantom Assassin",52,"Leshrac",24,44,68,0.352941176470588,0.871794871794872
44,"Phantom Assassin",53,"Nature's Prophet",69,141,210,0.328571428571429,2.69230769230769
44,"Phantom Assassin",54,"Lifestealer",40,70,110,0.363636363636364,1.41025641025641
44,"Phantom Assassin",55,"Dark Seer",99,109,208,0.475961538461538,2.66666666666667
44,"Phantom Assassin",56,"Clinkz",42,62,104,0.403846153846154,1.33333333333333
44,"Phantom Assassin",57,"Omniknight",295,197,492,0.599593495934959,6.30769230769231
44,"Phantom Assassin",58,"Enchantress",24,29,53,0.452830188679245,0.67948717948718
44,"Phantom Assassin",59,"Huskar",69,91,160,0.43125,2.05128205128205
44,"Phantom Assassin",60,"Night Stalker",63,85,148,0.425675675675676,1.8974358974359
44,"Phantom Assassin",61,"Broodmother",30,45,75,0.4,0.961538461538462
44,"Phantom Assassin",62,"Bounty Hunter",165,187,352,0.46875,4.51282051282051
44,"Phantom Assassin",63,"Weaver",53,63,116,0.456896551724138,1.48717948717949
44,"Phantom Assassin",64,"Jakiro",80,70,150,0.533333333333333,1.92307692307692
44,"Phantom Assassin",65,"Batrider",19,41,60,0.316666666666667,0.769230769230769
44,"Phantom Assassin",66,"Chen",16,16,32,0.5,0.41025641025641
44,"Phantom Assassin",67,"Spectre",57,58,115,0.495652173913044,1.47435897435897
44,"Phantom Assassin",68,"Ancient Apparition",166,216,382,0.43455497382199,4.8974358974359
44,"Phantom Assassin",69,"Doom",178,192,370,0.481081081081081,4.74358974358974
44,"Phantom Assassin",70,"Ursa",101,91,192,0.526041666666667,2.46153846153846
44,"Phantom Assassin",71,"Spirit Breaker",190,190,380,0.5,4.87179487179487
44,"Phantom Assassin",72,"Gyrocopter",59,73,132,0.446969696969697,1.69230769230769
44,"Phantom Assassin",73,"Alchemist",177,214,391,0.452685421994885,5.01282051282051
44,"Phantom Assassin",74,"Invoker",321,348,669,0.479820627802691,8.57692307692308
44,"Phantom Assassin",75,"Silencer",218,215,433,0.503464203233256,5.55128205128205
44,"Phantom Assassin",76,"Outworld Devourer",26,60,86,0.302325581395349,1.1025641025641
44,"Phantom Assassin",77,"Lycan",13,23,36,0.361111111111111,0.461538461538462
44,"Phantom Assassin",78,"Brewmaster",26,27,53,0.490566037735849,0.67948717948718
44,"Phantom Assassin",79,"Shadow Demon",44,47,91,0.483516483516484,1.16666666666667
44,"Phantom Assassin",80,"Lone Druid",22,23,45,0.488888888888889,0.576923076923077
44,"Phantom Assassin",81,"Chaos Knight",34,44,78,0.435897435897436,1
44,"Phantom Assassin",82,"Meepo",24,40,64,0.375,0.82051282051282
44,"Phantom Assassin",83,"Treant Protector",66,49,115,0.573913043478261,1.47435897435897
44,"Phantom Assassin",84,"Ogre Magi",133,115,248,0.536290322580645,3.17948717948718
44,"Phantom Assassin",85,"Undying",166,136,302,0.549668874172185,3.87179487179487
44,"Phantom Assassin",86,"Rubick",179,261,440,0.406818181818182,5.64102564102564
44,"Phantom Assassin",87,"Disruptor",147,127,274,0.536496350364963,3.51282051282051
44,"Phantom Assassin",88,"Nyx Assassin",63,71,134,0.470149253731343,1.71794871794872
44,"Phantom Assassin",89,"Naga Siren",21,35,56,0.375,0.717948717948718
44,"Phantom Assassin",90,"Keeper of the Light",51,75,126,0.404761904761905,1.61538461538462
44,"Phantom Assassin",91,"Io",32,42,74,0.432432432432432,0.948717948717949
44,"Phantom Assassin",92,"Visage",23,33,56,0.410714285714286,0.717948717948718
44,"Phantom Assassin",93,"Slark",89,113,202,0.440594059405941,2.58974358974359
44,"Phantom Assassin",94,"Medusa",37,29,66,0.560606060606061,0.846153846153846
44,"Phantom Assassin",95,"Troll Warlord",30,28,58,0.517241379310345,0.743589743589744
44,"Phantom Assassin",96,"Centaur Warrunner",52,55,107,0.485981308411215,1.37179487179487
44,"Phantom Assassin",97,"Magnus",91,152,243,0.374485596707819,3.11538461538462
44,"Phantom Assassin",98,"Timbersaw",72,95,167,0.431137724550898,2.14102564102564
44,"Phantom Assassin",99,"Bristleback",124,159,283,0.438162544169611,3.62820512820513
44,"Phantom Assassin",100,"Tusk",234,317,551,0.424682395644283,7.06410256410256
44,"Phantom Assassin",101,"Skywrath Mage",67,107,174,0.385057471264368,2.23076923076923
44,"Phantom Assassin",102,"Abaddon",110,78,188,0.585106382978723,2.41025641025641
44,"Phantom Assassin",103,"Elder Titan",19,26,45,0.422222222222222,0.576923076923077
44,"Phantom Assassin",104,"Legion Commander",187,249,436,0.428899082568807,5.58974358974359
44,"Phantom Assassin",105,"Techies",22,47,69,0.318840579710145,0.884615384615385
44,"Phantom Assassin",106,"Ember Spirit",98,146,244,0.401639344262295,3.12820512820513
44,"Phantom Assassin",107,"Earth Spirit",62,79,141,0.439716312056738,1.80769230769231
44,"Phantom Assassin",109,"Terrorblade",21,14,35,0.6,0.448717948717949
44,"Phantom Assassin",110,"Phoenix",64,80,144,0.444444444444444,1.84615384615385
44,"Phantom Assassin",111,"Oracle",24,37,61,0.39344262295082,0.782051282051282
44,"Phantom Assassin",112,"Winter Wyvern",174,210,384,0.453125,4.92307692307692
45,"Pugna",46,"Templar Assassin",46,35,81,0.567901234567901,1.03846153846154
45,"Pugna",47,"Viper",19,26,45,0.422222222222222,0.576923076923077
45,"Pugna",48,"Luna",10,14,24,0.416666666666667,0.307692307692308
45,"Pugna",49,"Dragon Knight",7,9,16,0.4375,0.205128205128205
45,"Pugna",50,"Dazzle",36,28,64,0.5625,0.82051282051282
45,"Pugna",51,"Clockwerk",29,16,45,0.644444444444444,0.576923076923077
45,"Pugna",52,"Leshrac",13,5,18,0.722222222222222,0.230769230769231
45,"Pugna",53,"Nature's Prophet",15,20,35,0.428571428571429,0.448717948717949
45,"Pugna",54,"Lifestealer",8,18,26,0.307692307692308,0.333333333333333
45,"Pugna",55,"Dark Seer",17,10,27,0.62962962962963,0.346153846153846
45,"Pugna",56,"Clinkz",6,18,24,0.25,0.307692307692308
45,"Pugna",57,"Omniknight",18,22,40,0.45,0.512820512820513
45,"Pugna",58,"Enchantress",1,8,9,0.111111111111111,0.115384615384615
45,"Pugna",59,"Huskar",27,18,45,0.6,0.576923076923077
45,"Pugna",60,"Night Stalker",13,18,31,0.419354838709677,0.397435897435897
45,"Pugna",61,"Broodmother",8,6,14,0.571428571428571,0.179487179487179
45,"Pugna",62,"Bounty Hunter",27,36,63,0.428571428571429,0.807692307692308
45,"Pugna",63,"Weaver",15,16,31,0.483870967741935,0.397435897435897
45,"Pugna",64,"Jakiro",15,15,30,0.5,0.384615384615385
45,"Pugna",65,"Batrider",3,4,7,0.428571428571429,0.0897435897435897
45,"Pugna",66,"Chen",4,5,9,0.444444444444444,0.115384615384615
45,"Pugna",67,"Spectre",49,39,88,0.556818181818182,1.12820512820513
45,"Pugna",68,"Ancient Apparition",18,22,40,0.45,0.512820512820513
45,"Pugna",69,"Doom",48,28,76,0.631578947368421,0.974358974358974
45,"Pugna",70,"Ursa",37,18,55,0.672727272727273,0.705128205128205
45,"Pugna",71,"Spirit Breaker",51,36,87,0.586206896551724,1.11538461538462
45,"Pugna",72,"Gyrocopter",51,37,88,0.579545454545455,1.12820512820513
45,"Pugna",73,"Alchemist",60,66,126,0.476190476190476,1.61538461538462
45,"Pugna",74,"Invoker",59,63,122,0.483606557377049,1.56410256410256
45,"Pugna",75,"Silencer",28,32,60,0.466666666666667,0.769230769230769
45,"Pugna",76,"Outworld Devourer",5,5,10,0.5,0.128205128205128
45,"Pugna",77,"Lycan",5,7,12,0.416666666666667,0.153846153846154
45,"Pugna",78,"Brewmaster",5,11,16,0.3125,0.205128205128205
45,"Pugna",79,"Shadow Demon",6,5,11,0.545454545454545,0.141025641025641
45,"Pugna",80,"Lone Druid",6,7,13,0.461538461538462,0.166666666666667
45,"Pugna",81,"Chaos Knight",20,11,31,0.645161290322581,0.397435897435897
45,"Pugna",82,"Meepo",10,11,21,0.476190476190476,0.269230769230769
45,"Pugna",83,"Treant Protector",10,4,14,0.714285714285714,0.179487179487179
45,"Pugna",84,"Ogre Magi",19,26,45,0.422222222222222,0.576923076923077
45,"Pugna",85,"Undying",31,26,57,0.543859649122807,0.730769230769231
45,"Pugna",86,"Rubick",28,32,60,0.466666666666667,0.769230769230769
45,"Pugna",87,"Disruptor",12,14,26,0.461538461538462,0.333333333333333
45,"Pugna",88,"Nyx Assassin",16,19,35,0.457142857142857,0.448717948717949
45,"Pugna",89,"Naga Siren",7,1,8,0.875,0.102564102564103
45,"Pugna",90,"Keeper of the Light",8,4,12,0.666666666666667,0.153846153846154
45,"Pugna",91,"Io",7,4,11,0.636363636363636,0.141025641025641
45,"Pugna",92,"Visage",1,6,7,0.142857142857143,0.0897435897435897
45,"Pugna",93,"Slark",49,49,98,0.5,1.25641025641026
45,"Pugna",94,"Medusa",9,12,21,0.428571428571429,0.269230769230769
45,"Pugna",95,"Troll Warlord",9,13,22,0.409090909090909,0.282051282051282
45,"Pugna",96,"Centaur Warrunner",11,13,24,0.458333333333333,0.307692307692308
45,"Pugna",97,"Magnus",12,27,39,0.307692307692308,0.5
45,"Pugna",98,"Timbersaw",14,20,34,0.411764705882353,0.435897435897436
45,"Pugna",99,"Bristleback",19,24,43,0.441860465116279,0.551282051282051
45,"Pugna",100,"Tusk",45,51,96,0.46875,1.23076923076923
45,"Pugna",101,"Skywrath Mage",6,10,16,0.375,0.205128205128205
45,"Pugna",102,"Abaddon",13,15,28,0.464285714285714,0.358974358974359
45,"Pugna",103,"Elder Titan",7,3,10,0.7,0.128205128205128
45,"Pugna",104,"Legion Commander",41,70,111,0.369369369369369,1.42307692307692
45,"Pugna",105,"Techies",2,4,6,0.333333333333333,0.0769230769230769
45,"Pugna",106,"Ember Spirit",51,39,90,0.566666666666667,1.15384615384615
45,"Pugna",107,"Earth Spirit",7,9,16,0.4375,0.205128205128205
45,"Pugna",109,"Terrorblade",5,12,17,0.294117647058824,0.217948717948718
45,"Pugna",110,"Phoenix",18,13,31,0.580645161290323,0.397435897435897
45,"Pugna",111,"Oracle",1,4,5,0.2,0.0641025641025641
45,"Pugna",112,"Winter Wyvern",20,24,44,0.454545454545455,0.564102564102564
46,"Templar Assassin",47,"Viper",46,60,106,0.433962264150943,1.35897435897436
46,"Templar Assassin",48,"Luna",43,52,95,0.452631578947368,1.21794871794872
46,"Templar Assassin",49,"Dragon Knight",26,28,54,0.481481481481481,0.692307692307692
46,"Templar Assassin",50,"Dazzle",225,226,451,0.498891352549889,5.78205128205128
46,"Templar Assassin",51,"Clockwerk",120,88,208,0.576923076923077,2.66666666666667
46,"Templar Assassin",52,"Leshrac",15,27,42,0.357142857142857,0.538461538461538
46,"Templar Assassin",53,"Nature's Prophet",59,75,134,0.440298507462687,1.71794871794872
46,"Templar Assassin",54,"Lifestealer",46,60,106,0.433962264150943,1.35897435897436
46,"Templar Assassin",55,"Dark Seer",112,105,217,0.516129032258065,2.78205128205128
46,"Templar Assassin",56,"Clinkz",40,53,93,0.43010752688172,1.19230769230769
46,"Templar Assassin",57,"Omniknight",156,109,265,0.588679245283019,3.3974358974359
46,"Templar Assassin",58,"Enchantress",21,26,47,0.446808510638298,0.602564102564103
46,"Templar Assassin",59,"Huskar",71,75,146,0.486301369863014,1.87179487179487
46,"Templar Assassin",60,"Night Stalker",65,72,137,0.474452554744526,1.75641025641026
46,"Templar Assassin",61,"Broodmother",31,45,76,0.407894736842105,0.974358974358974
46,"Templar Assassin",62,"Bounty Hunter",173,130,303,0.570957095709571,3.88461538461538
46,"Templar Assassin",63,"Weaver",43,63,106,0.405660377358491,1.35897435897436
46,"Templar Assassin",64,"Jakiro",61,64,125,0.488,1.6025641025641
46,"Templar Assassin",65,"Batrider",20,35,55,0.363636363636364,0.705128205128205
46,"Templar Assassin",66,"Chen",9,13,22,0.409090909090909,0.282051282051282
46,"Templar Assassin",67,"Spectre",179,122,301,0.59468438538206,3.85897435897436
46,"Templar Assassin",68,"Ancient Apparition",165,169,334,0.494011976047904,4.28205128205128
46,"Templar Assassin",69,"Doom",235,201,436,0.538990825688073,5.58974358974359
46,"Templar Assassin",70,"Ursa",101,77,178,0.567415730337079,2.28205128205128
46,"Templar Assassin",71,"Spirit Breaker",167,161,328,0.509146341463415,4.20512820512821
46,"Templar Assassin",72,"Gyrocopter",179,155,334,0.535928143712575,4.28205128205128
46,"Templar Assassin",73,"Alchemist",103,111,214,0.481308411214953,2.74358974358974
46,"Templar Assassin",74,"Invoker",107,106,213,0.502347417840376,2.73076923076923
46,"Templar Assassin",75,"Silencer",144,158,302,0.47682119205298,3.87179487179487
46,"Templar Assassin",76,"Outworld Devourer",22,14,36,0.611111111111111,0.461538461538462
46,"Templar Assassin",77,"Lycan",18,25,43,0.418604651162791,0.551282051282051
46,"Templar Assassin",78,"Brewmaster",20,14,34,0.588235294117647,0.435897435897436
46,"Templar Assassin",79,"Shadow Demon",37,37,74,0.5,0.948717948717949
46,"Templar Assassin",80,"Lone Druid",14,32,46,0.304347826086957,0.58974358974359
46,"Templar Assassin",81,"Chaos Knight",53,51,104,0.509615384615385,1.33333333333333
46,"Templar Assassin",82,"Meepo",25,26,51,0.490196078431373,0.653846153846154
46,"Templar Assassin",83,"Treant Protector",38,32,70,0.542857142857143,0.897435897435897
46,"Templar Assassin",84,"Ogre Magi",136,93,229,0.593886462882096,2.93589743589744
46,"Templar Assassin",85,"Undying",165,135,300,0.55,3.84615384615385
46,"Templar Assassin",86,"Rubick",236,224,460,0.51304347826087,5.8974358974359
46,"Templar Assassin",87,"Disruptor",126,107,233,0.540772532188841,2.98717948717949
46,"Templar Assassin",88,"Nyx Assassin",52,67,119,0.436974789915966,1.52564102564103
46,"Templar Assassin",89,"Naga Siren",16,26,42,0.380952380952381,0.538461538461538
46,"Templar Assassin",90,"Keeper of the Light",42,44,86,0.488372093023256,1.1025641025641
46,"Templar Assassin",91,"Io",33,37,70,0.471428571428571,0.897435897435897
46,"Templar Assassin",92,"Visage",24,14,38,0.631578947368421,0.487179487179487
46,"Templar Assassin",93,"Slark",186,197,383,0.485639686684073,4.91025641025641
46,"Templar Assassin",94,"Medusa",47,40,87,0.540229885057471,1.11538461538462
46,"Templar Assassin",95,"Troll Warlord",24,50,74,0.324324324324324,0.948717948717949
46,"Templar Assassin",96,"Centaur Warrunner",47,35,82,0.573170731707317,1.05128205128205
46,"Templar Assassin",97,"Magnus",36,58,94,0.382978723404255,1.20512820512821
46,"Templar Assassin",98,"Timbersaw",67,82,149,0.449664429530201,1.91025641025641
46,"Templar Assassin",99,"Bristleback",92,95,187,0.491978609625668,2.3974358974359
46,"Templar Assassin",100,"Tusk",310,238,548,0.565693430656934,7.02564102564103
46,"Templar Assassin",101,"Skywrath Mage",69,95,164,0.420731707317073,2.1025641025641
46,"Templar Assassin",102,"Abaddon",103,66,169,0.609467455621302,2.16666666666667
46,"Templar Assassin",103,"Elder Titan",23,15,38,0.605263157894737,0.487179487179487
46,"Templar Assassin",104,"Legion Commander",164,193,357,0.459383753501401,4.57692307692308
46,"Templar Assassin",105,"Techies",26,38,64,0.40625,0.82051282051282
46,"Templar Assassin",106,"Ember Spirit",98,120,218,0.44954128440367,2.79487179487179
46,"Templar Assassin",107,"Earth Spirit",84,67,151,0.556291390728477,1.93589743589744
46,"Templar Assassin",109,"Terrorblade",27,30,57,0.473684210526316,0.730769230769231
46,"Templar Assassin",110,"Phoenix",61,67,128,0.4765625,1.64102564102564
46,"Templar Assassin",111,"Oracle",21,23,44,0.477272727272727,0.564102564102564
46,"Templar Assassin",112,"Winter Wyvern",225,195,420,0.535714285714286,5.38461538461539
47,"Viper",48,"Luna",26,36,62,0.419354838709677,0.794871794871795
47,"Viper",49,"Dragon Knight",26,22,48,0.541666666666667,0.615384615384615
47,"Viper",50,"Dazzle",117,110,227,0.515418502202643,2.91025641025641
47,"Viper",51,"Clockwerk",33,58,91,0.362637362637363,1.16666666666667
47,"Viper",52,"Leshrac",6,15,21,0.285714285714286,0.269230769230769
47,"Viper",53,"Nature's Prophet",35,54,89,0.393258426966292,1.14102564102564
47,"Viper",54,"Lifestealer",39,36,75,0.52,0.961538461538462
47,"Viper",55,"Dark Seer",50,50,100,0.5,1.28205128205128
47,"Viper",56,"Clinkz",22,27,49,0.448979591836735,0.628205128205128
47,"Viper",57,"Omniknight",85,72,157,0.54140127388535,2.01282051282051
47,"Viper",58,"Enchantress",6,18,24,0.25,0.307692307692308
47,"Viper",59,"Huskar",39,43,82,0.475609756097561,1.05128205128205
47,"Viper",60,"Night Stalker",42,29,71,0.591549295774648,0.91025641025641
47,"Viper",61,"Broodmother",17,19,36,0.472222222222222,0.461538461538462
47,"Viper",62,"Bounty Hunter",87,105,192,0.453125,2.46153846153846
47,"Viper",63,"Weaver",22,37,59,0.372881355932203,0.756410256410256
47,"Viper",64,"Jakiro",37,42,79,0.468354430379747,1.01282051282051
47,"Viper",65,"Batrider",8,13,21,0.380952380952381,0.269230769230769
47,"Viper",66,"Chen",5,12,17,0.294117647058824,0.217948717948718
47,"Viper",67,"Spectre",96,68,164,0.585365853658537,2.1025641025641
47,"Viper",68,"Ancient Apparition",103,113,216,0.476851851851852,2.76923076923077
47,"Viper",69,"Doom",91,91,182,0.5,2.33333333333333
47,"Viper",70,"Ursa",57,51,108,0.527777777777778,1.38461538461538
47,"Viper",71,"Spirit Breaker",100,104,204,0.490196078431373,2.61538461538462
47,"Viper",72,"Gyrocopter",78,66,144,0.541666666666667,1.84615384615385
47,"Viper",73,"Alchemist",113,98,211,0.535545023696682,2.70512820512821
47,"Viper",74,"Invoker",121,107,228,0.530701754385965,2.92307692307692
47,"Viper",75,"Silencer",97,92,189,0.513227513227513,2.42307692307692
47,"Viper",76,"Outworld Devourer",9,22,31,0.290322580645161,0.397435897435897
47,"Viper",77,"Lycan",16,13,29,0.551724137931034,0.371794871794872
47,"Viper",78,"Brewmaster",13,10,23,0.565217391304348,0.294871794871795
47,"Viper",79,"Shadow Demon",20,15,35,0.571428571428571,0.448717948717949
47,"Viper",80,"Lone Druid",12,15,27,0.444444444444444,0.346153846153846
47,"Viper",81,"Chaos Knight",43,37,80,0.5375,1.02564102564103
47,"Viper",82,"Meepo",15,22,37,0.405405405405405,0.474358974358974
47,"Viper",83,"Treant Protector",29,26,55,0.527272727272727,0.705128205128205
47,"Viper",84,"Ogre Magi",75,78,153,0.490196078431373,1.96153846153846
47,"Viper",85,"Undying",124,87,211,0.587677725118483,2.70512820512821
47,"Viper",86,"Rubick",82,127,209,0.392344497607655,2.67948717948718
47,"Viper",87,"Disruptor",76,48,124,0.612903225806452,1.58974358974359
47,"Viper",88,"Nyx Assassin",31,39,70,0.442857142857143,0.897435897435897
47,"Viper",89,"Naga Siren",15,15,30,0.5,0.384615384615385
47,"Viper",90,"Keeper of the Light",24,30,54,0.444444444444444,0.692307692307692
47,"Viper",91,"Io",21,21,42,0.5,0.538461538461538
47,"Viper",92,"Visage",18,14,32,0.5625,0.41025641025641
47,"Viper",93,"Slark",118,99,217,0.543778801843318,2.78205128205128
47,"Viper",94,"Medusa",43,34,77,0.558441558441558,0.987179487179487
47,"Viper",95,"Troll Warlord",27,23,50,0.54,0.641025641025641
47,"Viper",96,"Centaur Warrunner",26,24,50,0.52,0.641025641025641
47,"Viper",97,"Magnus",25,28,53,0.471698113207547,0.67948717948718
47,"Viper",98,"Timbersaw",28,37,65,0.430769230769231,0.833333333333333
47,"Viper",99,"Bristleback",46,69,115,0.4,1.47435897435897
47,"Viper",100,"Tusk",143,132,275,0.52,3.52564102564103
47,"Viper",101,"Skywrath Mage",44,49,93,0.473118279569892,1.19230769230769
47,"Viper",102,"Abaddon",61,44,105,0.580952380952381,1.34615384615385
47,"Viper",103,"Elder Titan",14,13,27,0.518518518518518,0.346153846153846
47,"Viper",104,"Legion Commander",126,127,253,0.49802371541502,3.24358974358974
47,"Viper",105,"Techies",20,12,32,0.625,0.41025641025641
47,"Viper",106,"Ember Spirit",67,92,159,0.421383647798742,2.03846153846154
47,"Viper",107,"Earth Spirit",42,26,68,0.617647058823529,0.871794871794872
47,"Viper",109,"Terrorblade",22,23,45,0.488888888888889,0.576923076923077
47,"Viper",110,"Phoenix",46,30,76,0.605263157894737,0.974358974358974
47,"Viper",111,"Oracle",12,27,39,0.307692307692308,0.5
47,"Viper",112,"Winter Wyvern",123,116,239,0.514644351464435,3.06410256410256
48,"Luna",49,"Dragon Knight",10,14,24,0.416666666666667,0.307692307692308
48,"Luna",50,"Dazzle",85,67,152,0.559210526315789,1.94871794871795
48,"Luna",51,"Clockwerk",48,36,84,0.571428571428571,1.07692307692308
48,"Luna",52,"Leshrac",8,12,20,0.4,0.256410256410256
48,"Luna",53,"Nature's Prophet",27,34,61,0.442622950819672,0.782051282051282
48,"Luna",54,"Lifestealer",18,25,43,0.418604651162791,0.551282051282051
48,"Luna",55,"Dark Seer",45,36,81,0.555555555555556,1.03846153846154
48,"Luna",56,"Clinkz",13,15,28,0.464285714285714,0.358974358974359
48,"Luna",57,"Omniknight",74,52,126,0.587301587301587,1.61538461538462
48,"Luna",58,"Enchantress",14,18,32,0.4375,0.41025641025641
48,"Luna",59,"Huskar",25,22,47,0.531914893617021,0.602564102564103
48,"Luna",60,"Night Stalker",31,23,54,0.574074074074074,0.692307692307692
48,"Luna",61,"Broodmother",8,21,29,0.275862068965517,0.371794871794872
48,"Luna",62,"Bounty Hunter",61,51,112,0.544642857142857,1.43589743589744
48,"Luna",63,"Weaver",19,15,34,0.558823529411765,0.435897435897436
48,"Luna",64,"Jakiro",40,27,67,0.597014925373134,0.858974358974359
48,"Luna",65,"Batrider",10,8,18,0.555555555555556,0.230769230769231
48,"Luna",66,"Chen",6,4,10,0.6,0.128205128205128
48,"Luna",67,"Spectre",15,7,22,0.681818181818182,0.282051282051282
48,"Luna",68,"Ancient Apparition",65,54,119,0.546218487394958,1.52564102564103
48,"Luna",69,"Doom",66,58,124,0.532258064516129,1.58974358974359
48,"Luna",70,"Ursa",41,23,64,0.640625,0.82051282051282
48,"Luna",71,"Spirit Breaker",82,55,137,0.598540145985402,1.75641025641026
48,"Luna",72,"Gyrocopter",24,20,44,0.545454545454545,0.564102564102564
48,"Luna",73,"Alchemist",81,74,155,0.52258064516129,1.98717948717949
48,"Luna",74,"Invoker",92,92,184,0.5,2.35897435897436
48,"Luna",75,"Silencer",65,47,112,0.580357142857143,1.43589743589744
48,"Luna",76,"Outworld Devourer",20,7,27,0.740740740740741,0.346153846153846
48,"Luna",77,"Lycan",8,5,13,0.615384615384615,0.166666666666667
48,"Luna",78,"Brewmaster",8,7,15,0.533333333333333,0.192307692307692
48,"Luna",79,"Shadow Demon",4,24,28,0.142857142857143,0.358974358974359
48,"Luna",80,"Lone Druid",5,5,10,0.5,0.128205128205128
48,"Luna",81,"Chaos Knight",10,13,23,0.434782608695652,0.294871794871795
48,"Luna",82,"Meepo",13,7,20,0.65,0.256410256410256
48,"Luna",83,"Treant Protector",24,13,37,0.648648648648649,0.474358974358974
48,"Luna",84,"Ogre Magi",57,43,100,0.57,1.28205128205128
48,"Luna",85,"Undying",65,40,105,0.619047619047619,1.34615384615385
48,"Luna",86,"Rubick",75,67,142,0.528169014084507,1.82051282051282
48,"Luna",87,"Disruptor",48,37,85,0.564705882352941,1.08974358974359
48,"Luna",88,"Nyx Assassin",38,22,60,0.633333333333333,0.769230769230769
48,"Luna",89,"Naga Siren",2,5,7,0.285714285714286,0.0897435897435897
48,"Luna",90,"Keeper of the Light",13,24,37,0.351351351351351,0.474358974358974
48,"Luna",91,"Io",13,3,16,0.8125,0.205128205128205
48,"Luna",92,"Visage",10,10,20,0.5,0.256410256410256
48,"Luna",93,"Slark",25,35,60,0.416666666666667,0.769230769230769
48,"Luna",94,"Medusa",6,12,18,0.333333333333333,0.230769230769231
48,"Luna",95,"Troll Warlord",5,9,14,0.357142857142857,0.179487179487179
48,"Luna",96,"Centaur Warrunner",21,23,44,0.477272727272727,0.564102564102564
48,"Luna",97,"Magnus",26,25,51,0.509803921568627,0.653846153846154
48,"Luna",98,"Timbersaw",33,26,59,0.559322033898305,0.756410256410256
48,"Luna",99,"Bristleback",47,31,78,0.602564102564103,1
48,"Luna",100,"Tusk",90,94,184,0.489130434782609,2.35897435897436
48,"Luna",101,"Skywrath Mage",26,26,52,0.5,0.666666666666667
48,"Luna",102,"Abaddon",44,28,72,0.611111111111111,0.923076923076923
48,"Luna",103,"Elder Titan",10,7,17,0.588235294117647,0.217948717948718
48,"Luna",104,"Legion Commander",68,67,135,0.503703703703704,1.73076923076923
48,"Luna",105,"Techies",16,18,34,0.470588235294118,0.435897435897436
48,"Luna",106,"Ember Spirit",60,43,103,0.58252427184466,1.32051282051282
48,"Luna",107,"Earth Spirit",25,30,55,0.454545454545455,0.705128205128205
48,"Luna",109,"Terrorblade",5,10,15,0.333333333333333,0.192307692307692
48,"Luna",110,"Phoenix",32,32,64,0.5,0.82051282051282
48,"Luna",111,"Oracle",12,14,26,0.461538461538462,0.333333333333333
48,"Luna",112,"Winter Wyvern",77,62,139,0.553956834532374,1.78205128205128
49,"Dragon Knight",50,"Dazzle",77,70,147,0.523809523809524,1.88461538461538
49,"Dragon Knight",51,"Clockwerk",34,16,50,0.68,0.641025641025641
49,"Dragon Knight",52,"Leshrac",8,12,20,0.4,0.256410256410256
49,"Dragon Knight",53,"Nature's Prophet",24,31,55,0.436363636363636,0.705128205128205
49,"Dragon Knight",54,"Lifestealer",11,17,28,0.392857142857143,0.358974358974359
49,"Dragon Knight",55,"Dark Seer",24,24,48,0.5,0.615384615384615
49,"Dragon Knight",56,"Clinkz",14,14,28,0.5,0.358974358974359
49,"Dragon Knight",57,"Omniknight",41,28,69,0.594202898550725,0.884615384615385
49,"Dragon Knight",58,"Enchantress",9,11,20,0.45,0.256410256410256
49,"Dragon Knight",59,"Huskar",27,26,53,0.509433962264151,0.67948717948718
49,"Dragon Knight",60,"Night Stalker",17,14,31,0.548387096774194,0.397435897435897
49,"Dragon Knight",61,"Broodmother",8,10,18,0.444444444444444,0.230769230769231
49,"Dragon Knight",62,"Bounty Hunter",47,60,107,0.439252336448598,1.37179487179487
49,"Dragon Knight",63,"Weaver",16,21,37,0.432432432432432,0.474358974358974
49,"Dragon Knight",64,"Jakiro",25,33,58,0.431034482758621,0.743589743589744
49,"Dragon Knight",65,"Batrider",8,3,11,0.727272727272727,0.141025641025641
49,"Dragon Knight",66,"Chen",3,10,13,0.230769230769231,0.166666666666667
49,"Dragon Knight",67,"Spectre",47,21,68,0.691176470588235,0.871794871794872
49,"Dragon Knight",68,"Ancient Apparition",57,52,109,0.522935779816514,1.3974358974359
49,"Dragon Knight",69,"Doom",52,28,80,0.65,1.02564102564103
49,"Dragon Knight",70,"Ursa",33,14,47,0.702127659574468,0.602564102564103
49,"Dragon Knight",71,"Spirit Breaker",40,33,73,0.547945205479452,0.935897435897436
49,"Dragon Knight",72,"Gyrocopter",41,46,87,0.471264367816092,1.11538461538462
49,"Dragon Knight",73,"Alchemist",55,69,124,0.443548387096774,1.58974358974359
49,"Dragon Knight",74,"Invoker",73,79,152,0.480263157894737,1.94871794871795
49,"Dragon Knight",75,"Silencer",54,51,105,0.514285714285714,1.34615384615385
49,"Dragon Knight",76,"Outworld Devourer",8,9,17,0.470588235294118,0.217948717948718
49,"Dragon Knight",77,"Lycan",9,9,18,0.5,0.230769230769231
49,"Dragon Knight",78,"Brewmaster",7,2,9,0.777777777777778,0.115384615384615
49,"Dragon Knight",79,"Shadow Demon",10,15,25,0.4,0.320512820512821
49,"Dragon Knight",80,"Lone Druid",5,7,12,0.416666666666667,0.153846153846154
49,"Dragon Knight",81,"Chaos Knight",10,8,18,0.555555555555556,0.230769230769231
49,"Dragon Knight",82,"Meepo",8,7,15,0.533333333333333,0.192307692307692
49,"Dragon Knight",83,"Treant Protector",6,10,16,0.375,0.205128205128205
49,"Dragon Knight",84,"Ogre Magi",34,44,78,0.435897435897436,1
49,"Dragon Knight",85,"Undying",31,35,66,0.46969696969697,0.846153846153846
49,"Dragon Knight",86,"Rubick",51,71,122,0.418032786885246,1.56410256410256
49,"Dragon Knight",87,"Disruptor",43,27,70,0.614285714285714,0.897435897435897
49,"Dragon Knight",88,"Nyx Assassin",17,16,33,0.515151515151515,0.423076923076923
49,"Dragon Knight",89,"Naga Siren",11,14,25,0.44,0.320512820512821
49,"Dragon Knight",90,"Keeper of the Light",20,27,47,0.425531914893617,0.602564102564103
49,"Dragon Knight",91,"Io",9,15,24,0.375,0.307692307692308
49,"Dragon Knight",92,"Visage",7,5,12,0.583333333333333,0.153846153846154
49,"Dragon Knight",93,"Slark",48,51,99,0.484848484848485,1.26923076923077
49,"Dragon Knight",94,"Medusa",26,20,46,0.565217391304348,0.58974358974359
49,"Dragon Knight",95,"Troll Warlord",8,7,15,0.533333333333333,0.192307692307692
49,"Dragon Knight",96,"Centaur Warrunner",14,12,26,0.538461538461538,0.333333333333333
49,"Dragon Knight",97,"Magnus",15,18,33,0.454545454545455,0.423076923076923
49,"Dragon Knight",98,"Timbersaw",13,25,38,0.342105263157895,0.487179487179487
49,"Dragon Knight",99,"Bristleback",13,23,36,0.361111111111111,0.461538461538462
49,"Dragon Knight",100,"Tusk",58,57,115,0.504347826086956,1.47435897435897
49,"Dragon Knight",101,"Skywrath Mage",16,28,44,0.363636363636364,0.564102564102564
49,"Dragon Knight",102,"Abaddon",30,20,50,0.6,0.641025641025641
49,"Dragon Knight",103,"Elder Titan",10,5,15,0.666666666666667,0.192307692307692
49,"Dragon Knight",104,"Legion Commander",59,73,132,0.446969696969697,1.69230769230769
49,"Dragon Knight",105,"Techies",11,9,20,0.55,0.256410256410256
49,"Dragon Knight",106,"Ember Spirit",42,30,72,0.583333333333333,0.923076923076923
49,"Dragon Knight",107,"Earth Spirit",17,16,33,0.515151515151515,0.423076923076923
49,"Dragon Knight",109,"Terrorblade",10,8,18,0.555555555555556,0.230769230769231
49,"Dragon Knight",110,"Phoenix",17,18,35,0.485714285714286,0.448717948717949
49,"Dragon Knight",111,"Oracle",9,7,16,0.5625,0.205128205128205
49,"Dragon Knight",112,"Winter Wyvern",52,63,115,0.452173913043478,1.47435897435897
50,"Dazzle",51,"Clockwerk",140,126,266,0.526315789473684,3.41025641025641
50,"Dazzle",52,"Leshrac",30,32,62,0.483870967741935,0.794871794871795
50,"Dazzle",53,"Nature's Prophet",79,87,166,0.475903614457831,2.12820512820513
50,"Dazzle",54,"Lifestealer",56,66,122,0.459016393442623,1.56410256410256
50,"Dazzle",55,"Dark Seer",150,129,279,0.537634408602151,3.57692307692308
50,"Dazzle",56,"Clinkz",78,71,149,0.523489932885906,1.91025641025641
50,"Dazzle",57,"Omniknight",105,55,160,0.65625,2.05128205128205
50,"Dazzle",58,"Enchantress",21,24,45,0.466666666666667,0.576923076923077
50,"Dazzle",59,"Huskar",364,308,672,0.541666666666667,8.61538461538461
50,"Dazzle",60,"Night Stalker",86,101,187,0.459893048128342,2.3974358974359
50,"Dazzle",61,"Broodmother",42,65,107,0.392523364485981,1.37179487179487
50,"Dazzle",62,"Bounty Hunter",183,155,338,0.541420118343195,4.33333333333333
50,"Dazzle",63,"Weaver",84,59,143,0.587412587412587,1.83333333333333
50,"Dazzle",64,"Jakiro",63,48,111,0.567567567567568,1.42307692307692
50,"Dazzle",65,"Batrider",24,39,63,0.380952380952381,0.807692307692308
50,"Dazzle",66,"Chen",13,13,26,0.5,0.333333333333333
50,"Dazzle",67,"Spectre",324,177,501,0.646706586826347,6.42307692307692
50,"Dazzle",68,"Ancient Apparition",93,91,184,0.505434782608696,2.35897435897436
50,"Dazzle",69,"Doom",309,228,537,0.575418994413408,6.88461538461539
50,"Dazzle",70,"Ursa",158,113,271,0.583025830258303,3.47435897435897
50,"Dazzle",71,"Spirit Breaker",257,208,465,0.552688172043011,5.96153846153846
50,"Dazzle",72,"Gyrocopter",260,246,506,0.513833992094862,6.48717948717949
50,"Dazzle",73,"Alchemist",401,313,714,0.561624649859944,9.15384615384615
50,"Dazzle",74,"Invoker",396,375,771,0.513618677042802,9.88461538461539
50,"Dazzle",75,"Silencer",139,132,271,0.512915129151292,3.47435897435897
50,"Dazzle",76,"Outworld Devourer",56,45,101,0.554455445544555,1.29487179487179
50,"Dazzle",77,"Lycan",39,25,64,0.609375,0.82051282051282
50,"Dazzle",78,"Brewmaster",33,33,66,0.5,0.846153846153846
50,"Dazzle",79,"Shadow Demon",31,31,62,0.5,0.794871794871795
50,"Dazzle",80,"Lone Druid",20,30,50,0.4,0.641025641025641
50,"Dazzle",81,"Chaos Knight",79,83,162,0.487654320987654,2.07692307692308
50,"Dazzle",82,"Meepo",81,66,147,0.551020408163265,1.88461538461538
50,"Dazzle",83,"Treant Protector",37,25,62,0.596774193548387,0.794871794871795
50,"Dazzle",84,"Ogre Magi",91,83,174,0.522988505747126,2.23076923076923
50,"Dazzle",85,"Undying",228,138,366,0.622950819672131,4.69230769230769
50,"Dazzle",86,"Rubick",138,158,296,0.466216216216216,3.79487179487179
50,"Dazzle",87,"Disruptor",74,72,146,0.506849315068493,1.87179487179487
50,"Dazzle",88,"Nyx Assassin",90,80,170,0.529411764705882,2.17948717948718
50,"Dazzle",89,"Naga Siren",35,28,63,0.555555555555556,0.807692307692308
50,"Dazzle",90,"Keeper of the Light",22,29,51,0.431372549019608,0.653846153846154
50,"Dazzle",91,"Io",32,47,79,0.40506329113924,1.01282051282051
50,"Dazzle",92,"Visage",20,14,34,0.588235294117647,0.435897435897436
50,"Dazzle",93,"Slark",254,289,543,0.467771639042357,6.96153846153846
50,"Dazzle",94,"Medusa",88,70,158,0.556962025316456,2.02564102564103
50,"Dazzle",95,"Troll Warlord",61,49,110,0.554545454545455,1.41025641025641
50,"Dazzle",96,"Centaur Warrunner",77,70,147,0.523809523809524,1.88461538461538
50,"Dazzle",97,"Magnus",106,128,234,0.452991452991453,3
50,"Dazzle",98,"Timbersaw",82,85,167,0.491017964071856,2.14102564102564
50,"Dazzle",99,"Bristleback",162,151,313,0.517571884984026,4.01282051282051
50,"Dazzle",100,"Tusk",379,311,690,0.549275362318841,8.84615384615385
50,"Dazzle",101,"Skywrath Mage",48,65,113,0.424778761061947,1.44871794871795
50,"Dazzle",102,"Abaddon",87,55,142,0.612676056338028,1.82051282051282
50,"Dazzle",103,"Elder Titan",19,29,48,0.395833333333333,0.615384615384615
50,"Dazzle",104,"Legion Commander",289,281,570,0.507017543859649,7.30769230769231
50,"Dazzle",105,"Techies",26,28,54,0.481481481481481,0.692307692307692
50,"Dazzle",106,"Ember Spirit",279,274,553,0.504520795660036,7.08974358974359
50,"Dazzle",107,"Earth Spirit",83,78,161,0.515527950310559,2.06410256410256
50,"Dazzle",109,"Terrorblade",69,49,118,0.584745762711864,1.51282051282051
50,"Dazzle",110,"Phoenix",104,85,189,0.55026455026455,2.42307692307692
50,"Dazzle",111,"Oracle",25,21,46,0.543478260869565,0.58974358974359
50,"Dazzle",112,"Winter Wyvern",136,111,247,0.550607287449393,3.16666666666667
51,"Clockwerk",52,"Leshrac",11,17,28,0.392857142857143,0.358974358974359
51,"Clockwerk",53,"Nature's Prophet",50,62,112,0.446428571428571,1.43589743589744
51,"Clockwerk",54,"Lifestealer",39,57,96,0.40625,1.23076923076923
51,"Clockwerk",55,"Dark Seer",16,14,30,0.533333333333333,0.384615384615385
51,"Clockwerk",56,"Clinkz",38,27,65,0.584615384615385,0.833333333333333
51,"Clockwerk",57,"Omniknight",97,69,166,0.58433734939759,2.12820512820513
51,"Clockwerk",58,"Enchantress",10,16,26,0.384615384615385,0.333333333333333
51,"Clockwerk",59,"Huskar",49,40,89,0.550561797752809,1.14102564102564
51,"Clockwerk",60,"Night Stalker",22,32,54,0.407407407407407,0.692307692307692
51,"Clockwerk",61,"Broodmother",3,6,9,0.333333333333333,0.115384615384615
51,"Clockwerk",62,"Bounty Hunter",129,104,233,0.553648068669528,2.98717948717949
51,"Clockwerk",63,"Weaver",17,20,37,0.459459459459459,0.474358974358974
51,"Clockwerk",64,"Jakiro",45,50,95,0.473684210526316,1.21794871794872
51,"Clockwerk",65,"Batrider",7,11,18,0.388888888888889,0.230769230769231
51,"Clockwerk",66,"Chen",15,9,24,0.625,0.307692307692308
51,"Clockwerk",67,"Spectre",160,118,278,0.575539568345324,3.56410256410256
51,"Clockwerk",68,"Ancient Apparition",133,147,280,0.475,3.58974358974359
51,"Clockwerk",69,"Doom",70,63,133,0.526315789473684,1.70512820512821
51,"Clockwerk",70,"Ursa",83,47,130,0.638461538461538,1.66666666666667
51,"Clockwerk",71,"Spirit Breaker",75,53,128,0.5859375,1.64102564102564
51,"Clockwerk",72,"Gyrocopter",102,131,233,0.437768240343348,2.98717948717949
51,"Clockwerk",73,"Alchemist",195,166,361,0.54016620498615,4.62820512820513
51,"Clockwerk",74,"Invoker",204,205,409,0.498777506112469,5.24358974358974
51,"Clockwerk",75,"Silencer",140,114,254,0.551181102362205,3.25641025641026
51,"Clockwerk",76,"Outworld Devourer",19,31,50,0.38,0.641025641025641
51,"Clockwerk",77,"Lycan",17,18,35,0.485714285714286,0.448717948717949
51,"Clockwerk",78,"Brewmaster",6,13,19,0.315789473684211,0.243589743589744
51,"Clockwerk",79,"Shadow Demon",29,23,52,0.557692307692308,0.666666666666667
51,"Clockwerk",80,"Lone Druid",11,19,30,0.366666666666667,0.384615384615385
51,"Clockwerk",81,"Chaos Knight",34,26,60,0.566666666666667,0.769230769230769
51,"Clockwerk",82,"Meepo",20,27,47,0.425531914893617,0.602564102564103
51,"Clockwerk",83,"Treant Protector",21,18,39,0.538461538461538,0.5
51,"Clockwerk",84,"Ogre Magi",64,67,131,0.488549618320611,1.67948717948718
51,"Clockwerk",85,"Undying",53,55,108,0.490740740740741,1.38461538461538
51,"Clockwerk",86,"Rubick",163,188,351,0.464387464387464,4.5
51,"Clockwerk",87,"Disruptor",86,86,172,0.5,2.20512820512821
51,"Clockwerk",88,"Nyx Assassin",28,16,44,0.636363636363636,0.564102564102564
51,"Clockwerk",89,"Naga Siren",7,16,23,0.304347826086957,0.294871794871795
51,"Clockwerk",90,"Keeper of the Light",38,32,70,0.542857142857143,0.897435897435897
51,"Clockwerk",91,"Io",30,30,60,0.5,0.769230769230769
51,"Clockwerk",92,"Visage",11,23,34,0.323529411764706,0.435897435897436
51,"Clockwerk",93,"Slark",123,139,262,0.469465648854962,3.35897435897436
51,"Clockwerk",94,"Medusa",36,36,72,0.5,0.923076923076923
51,"Clockwerk",95,"Troll Warlord",23,17,40,0.575,0.512820512820513
51,"Clockwerk",96,"Centaur Warrunner",8,8,16,0.5,0.205128205128205
51,"Clockwerk",97,"Magnus",22,35,57,0.385964912280702,0.730769230769231
51,"Clockwerk",98,"Timbersaw",9,16,25,0.36,0.320512820512821
51,"Clockwerk",99,"Bristleback",16,22,38,0.421052631578947,0.487179487179487
51,"Clockwerk",100,"Tusk",95,112,207,0.458937198067633,2.65384615384615
51,"Clockwerk",101,"Skywrath Mage",68,66,134,0.507462686567164,1.71794871794872
51,"Clockwerk",102,"Abaddon",47,38,85,0.552941176470588,1.08974358974359
51,"Clockwerk",103,"Elder Titan",4,5,9,0.444444444444444,0.115384615384615
51,"Clockwerk",104,"Legion Commander",123,120,243,0.506172839506173,3.11538461538462
51,"Clockwerk",105,"Techies",10,15,25,0.4,0.320512820512821
51,"Clockwerk",106,"Ember Spirit",116,169,285,0.407017543859649,3.65384615384615
51,"Clockwerk",107,"Earth Spirit",32,25,57,0.56140350877193,0.730769230769231
51,"Clockwerk",109,"Terrorblade",27,36,63,0.428571428571429,0.807692307692308
51,"Clockwerk",110,"Phoenix",21,16,37,0.567567567567568,0.474358974358974
51,"Clockwerk",111,"Oracle",14,13,27,0.518518518518518,0.346153846153846
51,"Clockwerk",112,"Winter Wyvern",164,144,308,0.532467532467532,3.94871794871795
52,"Leshrac",53,"Nature's Prophet",6,18,24,0.25,0.307692307692308
52,"Leshrac",54,"Lifestealer",13,17,30,0.433333333333333,0.384615384615385
52,"Leshrac",55,"Dark Seer",18,13,31,0.580645161290323,0.397435897435897
52,"Leshrac",56,"Clinkz",6,10,16,0.375,0.205128205128205
52,"Leshrac",57,"Omniknight",22,14,36,0.611111111111111,0.461538461538462
52,"Leshrac",58,"Enchantress",4,1,5,0.8,0.0641025641025641
52,"Leshrac",59,"Huskar",17,21,38,0.447368421052632,0.487179487179487
52,"Leshrac",60,"Night Stalker",14,18,32,0.4375,0.41025641025641
52,"Leshrac",61,"Broodmother",6,6,12,0.5,0.153846153846154
52,"Leshrac",62,"Bounty Hunter",28,26,54,0.518518518518518,0.692307692307692
52,"Leshrac",63,"Weaver",6,12,18,0.333333333333333,0.230769230769231
52,"Leshrac",64,"Jakiro",12,14,26,0.461538461538462,0.333333333333333
52,"Leshrac",65,"Batrider",4,6,10,0.4,0.128205128205128
52,"Leshrac",66,"Chen",1,5,6,0.166666666666667,0.0769230769230769
52,"Leshrac",67,"Spectre",42,19,61,0.688524590163934,0.782051282051282
52,"Leshrac",68,"Ancient Apparition",17,26,43,0.395348837209302,0.551282051282051
52,"Leshrac",69,"Doom",40,27,67,0.597014925373134,0.858974358974359
52,"Leshrac",70,"Ursa",17,22,39,0.435897435897436,0.5
52,"Leshrac",71,"Spirit Breaker",23,39,62,0.370967741935484,0.794871794871795
52,"Leshrac",72,"Gyrocopter",27,26,53,0.509433962264151,0.67948717948718
52,"Leshrac",73,"Alchemist",46,46,92,0.5,1.17948717948718
52,"Leshrac",74,"Invoker",40,53,93,0.43010752688172,1.19230769230769
52,"Leshrac",75,"Silencer",32,21,53,0.60377358490566,0.67948717948718
52,"Leshrac",76,"Outworld Devourer",7,8,15,0.466666666666667,0.192307692307692
52,"Leshrac",77,"Lycan",7,4,11,0.636363636363636,0.141025641025641
52,"Leshrac",78,"Brewmaster",2,3,5,0.4,0.0641025641025641
52,"Leshrac",79,"Shadow Demon",11,14,25,0.44,0.320512820512821
52,"Leshrac",80,"Lone Druid",1,9,10,0.1,0.128205128205128
52,"Leshrac",81,"Chaos Knight",10,20,30,0.333333333333333,0.384615384615385
52,"Leshrac",82,"Meepo",9,4,13,0.692307692307692,0.166666666666667
52,"Leshrac",83,"Treant Protector",8,6,14,0.571428571428571,0.179487179487179
52,"Leshrac",84,"Ogre Magi",16,13,29,0.551724137931034,0.371794871794872
52,"Leshrac",85,"Undying",22,36,58,0.379310344827586,0.743589743589744
52,"Leshrac",86,"Rubick",20,33,53,0.377358490566038,0.67948717948718
52,"Leshrac",87,"Disruptor",13,20,33,0.393939393939394,0.423076923076923
52,"Leshrac",88,"Nyx Assassin",10,21,31,0.32258064516129,0.397435897435897
52,"Leshrac",89,"Naga Siren",4,4,8,0.5,0.102564102564103
52,"Leshrac",90,"Keeper of the Light",14,9,23,0.608695652173913,0.294871794871795
52,"Leshrac",91,"Io",6,6,12,0.5,0.153846153846154
52,"Leshrac",92,"Visage",5,3,8,0.625,0.102564102564103
52,"Leshrac",93,"Slark",38,41,79,0.481012658227848,1.01282051282051
52,"Leshrac",94,"Medusa",10,7,17,0.588235294117647,0.217948717948718
52,"Leshrac",95,"Troll Warlord",10,5,15,0.666666666666667,0.192307692307692
52,"Leshrac",96,"Centaur Warrunner",9,11,20,0.45,0.256410256410256
52,"Leshrac",97,"Magnus",11,18,29,0.379310344827586,0.371794871794872
52,"Leshrac",98,"Timbersaw",11,12,23,0.478260869565217,0.294871794871795
52,"Leshrac",99,"Bristleback",20,21,41,0.48780487804878,0.525641025641026
52,"Leshrac",100,"Tusk",40,43,83,0.481927710843373,1.06410256410256
52,"Leshrac",101,"Skywrath Mage",16,22,38,0.421052631578947,0.487179487179487
52,"Leshrac",102,"Abaddon",15,13,28,0.535714285714286,0.358974358974359
52,"Leshrac",103,"Elder Titan",5,3,8,0.625,0.102564102564103
52,"Leshrac",104,"Legion Commander",39,52,91,0.428571428571429,1.16666666666667
52,"Leshrac",105,"Techies",3,4,7,0.428571428571429,0.0897435897435897
52,"Leshrac",106,"Ember Spirit",18,35,53,0.339622641509434,0.67948717948718
52,"Leshrac",107,"Earth Spirit",9,11,20,0.45,0.256410256410256
52,"Leshrac",109,"Terrorblade",12,4,16,0.75,0.205128205128205
52,"Leshrac",110,"Phoenix",9,11,20,0.45,0.256410256410256
52,"Leshrac",111,"Oracle",3,4,7,0.428571428571429,0.0897435897435897
52,"Leshrac",112,"Winter Wyvern",30,37,67,0.447761194029851,0.858974358974359
53,"Nature's Prophet",54,"Lifestealer",11,33,44,0.25,0.564102564102564
53,"Nature's Prophet",55,"Dark Seer",44,48,92,0.478260869565217,1.17948717948718
53,"Nature's Prophet",56,"Clinkz",21,36,57,0.368421052631579,0.730769230769231
53,"Nature's Prophet",57,"Omniknight",57,59,116,0.491379310344828,1.48717948717949
53,"Nature's Prophet",58,"Enchantress",6,12,18,0.333333333333333,0.230769230769231
53,"Nature's Prophet",59,"Huskar",28,65,93,0.301075268817204,1.19230769230769
53,"Nature's Prophet",60,"Night Stalker",32,33,65,0.492307692307692,0.833333333333333
53,"Nature's Prophet",61,"Broodmother",20,28,48,0.416666666666667,0.615384615384615
53,"Nature's Prophet",62,"Bounty Hunter",42,71,113,0.371681415929204,1.44871794871795
53,"Nature's Prophet",63,"Weaver",22,33,55,0.4,0.705128205128205
53,"Nature's Prophet",64,"Jakiro",23,32,55,0.418181818181818,0.705128205128205
53,"Nature's Prophet",65,"Batrider",5,16,21,0.238095238095238,0.269230769230769
53,"Nature's Prophet",66,"Chen",7,6,13,0.538461538461538,0.166666666666667
53,"Nature's Prophet",67,"Spectre",107,90,197,0.543147208121827,2.52564102564103
53,"Nature's Prophet",68,"Ancient Apparition",57,81,138,0.41304347826087,1.76923076923077
53,"Nature's Prophet",69,"Doom",60,89,149,0.402684563758389,1.91025641025641
53,"Nature's Prophet",70,"Ursa",42,45,87,0.482758620689655,1.11538461538462
53,"Nature's Prophet",71,"Spirit Breaker",75,88,163,0.460122699386503,2.08974358974359
53,"Nature's Prophet",72,"Gyrocopter",68,91,159,0.427672955974843,2.03846153846154
53,"Nature's Prophet",73,"Alchemist",126,158,284,0.443661971830986,3.64102564102564
53,"Nature's Prophet",74,"Invoker",129,175,304,0.424342105263158,3.8974358974359
53,"Nature's Prophet",75,"Silencer",55,71,126,0.436507936507937,1.61538461538462
53,"Nature's Prophet",76,"Outworld Devourer",13,27,40,0.325,0.512820512820513
53,"Nature's Prophet",77,"Lycan",11,18,29,0.379310344827586,0.371794871794872
53,"Nature's Prophet",78,"Brewmaster",9,11,20,0.45,0.256410256410256
53,"Nature's Prophet",79,"Shadow Demon",10,16,26,0.384615384615385,0.333333333333333
53,"Nature's Prophet",80,"Lone Druid",8,14,22,0.363636363636364,0.282051282051282
53,"Nature's Prophet",81,"Chaos Knight",34,38,72,0.472222222222222,0.923076923076923
53,"Nature's Prophet",82,"Meepo",17,29,46,0.369565217391304,0.58974358974359
53,"Nature's Prophet",83,"Treant Protector",17,20,37,0.459459459459459,0.474358974358974
53,"Nature's Prophet",84,"Ogre Magi",37,57,94,0.393617021276596,1.20512820512821
53,"Nature's Prophet",85,"Undying",55,57,112,0.491071428571429,1.43589743589744
53,"Nature's Prophet",86,"Rubick",66,95,161,0.409937888198758,2.06410256410256
53,"Nature's Prophet",87,"Disruptor",35,53,88,0.397727272727273,1.12820512820513
53,"Nature's Prophet",88,"Nyx Assassin",22,31,53,0.415094339622642,0.67948717948718
53,"Nature's Prophet",89,"Naga Siren",8,11,19,0.421052631578947,0.243589743589744
53,"Nature's Prophet",90,"Keeper of the Light",14,32,46,0.304347826086957,0.58974358974359
53,"Nature's Prophet",91,"Io",8,14,22,0.363636363636364,0.282051282051282
53,"Nature's Prophet",92,"Visage",11,7,18,0.611111111111111,0.230769230769231
53,"Nature's Prophet",93,"Slark",87,140,227,0.383259911894273,2.91025641025641
53,"Nature's Prophet",94,"Medusa",30,38,68,0.441176470588235,0.871794871794872
53,"Nature's Prophet",95,"Troll Warlord",18,24,42,0.428571428571429,0.538461538461538
53,"Nature's Prophet",96,"Centaur Warrunner",16,31,47,0.340425531914894,0.602564102564103
53,"Nature's Prophet",97,"Magnus",26,54,80,0.325,1.02564102564103
53,"Nature's Prophet",98,"Timbersaw",25,58,83,0.301204819277108,1.06410256410256
53,"Nature's Prophet",99,"Bristleback",39,73,112,0.348214285714286,1.43589743589744
53,"Nature's Prophet",100,"Tusk",86,108,194,0.443298969072165,2.48717948717949
53,"Nature's Prophet",101,"Skywrath Mage",22,33,55,0.4,0.705128205128205
53,"Nature's Prophet",102,"Abaddon",41,33,74,0.554054054054054,0.948717948717949
53,"Nature's Prophet",103,"Elder Titan",7,15,22,0.318181818181818,0.282051282051282
53,"Nature's Prophet",104,"Legion Commander",80,99,179,0.446927374301676,2.29487179487179
53,"Nature's Prophet",105,"Techies",7,21,28,0.25,0.358974358974359
53,"Nature's Prophet",106,"Ember Spirit",67,139,206,0.325242718446602,2.64102564102564
53,"Nature's Prophet",107,"Earth Spirit",19,32,51,0.372549019607843,0.653846153846154
53,"Nature's Prophet",109,"Terrorblade",24,34,58,0.413793103448276,0.743589743589744
53,"Nature's Prophet",110,"Phoenix",32,36,68,0.470588235294118,0.871794871794872
53,"Nature's Prophet",111,"Oracle",7,12,19,0.368421052631579,0.243589743589744
53,"Nature's Prophet",112,"Winter Wyvern",66,75,141,0.468085106382979,1.80769230769231
54,"Lifestealer",55,"Dark Seer",40,25,65,0.615384615384615,0.833333333333333
54,"Lifestealer",56,"Clinkz",17,24,41,0.414634146341463,0.525641025641026
54,"Lifestealer",57,"Omniknight",53,49,102,0.519607843137255,1.30769230769231
54,"Lifestealer",58,"Enchantress",7,10,17,0.411764705882353,0.217948717948718
54,"Lifestealer",59,"Huskar",23,32,55,0.418181818181818,0.705128205128205
54,"Lifestealer",60,"Night Stalker",28,19,47,0.595744680851064,0.602564102564103
54,"Lifestealer",61,"Broodmother",9,13,22,0.409090909090909,0.282051282051282
54,"Lifestealer",62,"Bounty Hunter",55,80,135,0.407407407407407,1.73076923076923
54,"Lifestealer",63,"Weaver",25,25,50,0.5,0.641025641025641
54,"Lifestealer",64,"Jakiro",26,29,55,0.472727272727273,0.705128205128205
54,"Lifestealer",65,"Batrider",10,6,16,0.625,0.205128205128205
54,"Lifestealer",66,"Chen",2,4,6,0.333333333333333,0.0769230769230769
54,"Lifestealer",67,"Spectre",34,40,74,0.459459459459459,0.948717948717949
54,"Lifestealer",68,"Ancient Apparition",64,54,118,0.542372881355932,1.51282051282051
54,"Lifestealer",69,"Doom",49,55,104,0.471153846153846,1.33333333333333
54,"Lifestealer",70,"Ursa",35,30,65,0.538461538461538,0.833333333333333
54,"Lifestealer",71,"Spirit Breaker",101,83,184,0.548913043478261,2.35897435897436
54,"Lifestealer",72,"Gyrocopter",43,58,101,0.425742574257426,1.29487179487179
54,"Lifestealer",73,"Alchemist",79,93,172,0.459302325581395,2.20512820512821
54,"Lifestealer",74,"Invoker",119,128,247,0.481781376518219,3.16666666666667
54,"Lifestealer",75,"Silencer",74,73,147,0.503401360544218,1.88461538461538
54,"Lifestealer",76,"Outworld Devourer",12,20,32,0.375,0.41025641025641
54,"Lifestealer",77,"Lycan",6,7,13,0.461538461538462,0.166666666666667
54,"Lifestealer",78,"Brewmaster",5,8,13,0.384615384615385,0.166666666666667
54,"Lifestealer",79,"Shadow Demon",6,14,20,0.3,0.256410256410256
54,"Lifestealer",80,"Lone Druid",8,7,15,0.533333333333333,0.192307692307692
54,"Lifestealer",81,"Chaos Knight",9,23,32,0.28125,0.41025641025641
54,"Lifestealer",82,"Meepo",11,15,26,0.423076923076923,0.333333333333333
54,"Lifestealer",83,"Treant Protector",13,13,26,0.5,0.333333333333333
54,"Lifestealer",84,"Ogre Magi",36,46,82,0.439024390243902,1.05128205128205
54,"Lifestealer",85,"Undying",52,47,99,0.525252525252525,1.26923076923077
54,"Lifestealer",86,"Rubick",67,80,147,0.45578231292517,1.88461538461538
54,"Lifestealer",87,"Disruptor",48,47,95,0.505263157894737,1.21794871794872
54,"Lifestealer",88,"Nyx Assassin",26,25,51,0.509803921568627,0.653846153846154
54,"Lifestealer",89,"Naga Siren",4,8,12,0.333333333333333,0.153846153846154
54,"Lifestealer",90,"Keeper of the Light",20,24,44,0.454545454545455,0.564102564102564
54,"Lifestealer",91,"Io",9,11,20,0.45,0.256410256410256
54,"Lifestealer",92,"Visage",7,13,20,0.35,0.256410256410256
54,"Lifestealer",93,"Slark",44,83,127,0.346456692913386,1.62820512820513
54,"Lifestealer",94,"Medusa",24,17,41,0.585365853658537,0.525641025641026
54,"Lifestealer",95,"Troll Warlord",10,10,20,0.5,0.256410256410256
54,"Lifestealer",96,"Centaur Warrunner",18,16,34,0.529411764705882,0.435897435897436
54,"Lifestealer",97,"Magnus",24,30,54,0.444444444444444,0.692307692307692
54,"Lifestealer",98,"Timbersaw",22,28,50,0.44,0.641025641025641
54,"Lifestealer",99,"Bristleback",37,42,79,0.468354430379747,1.01282051282051
54,"Lifestealer",100,"Tusk",70,68,138,0.507246376811594,1.76923076923077
54,"Lifestealer",101,"Skywrath Mage",16,28,44,0.363636363636364,0.564102564102564
54,"Lifestealer",102,"Abaddon",33,26,59,0.559322033898305,0.756410256410256
54,"Lifestealer",103,"Elder Titan",5,3,8,0.625,0.102564102564103
54,"Lifestealer",104,"Legion Commander",51,79,130,0.392307692307692,1.66666666666667
54,"Lifestealer",105,"Techies",18,17,35,0.514285714285714,0.448717948717949
54,"Lifestealer",106,"Ember Spirit",52,54,106,0.490566037735849,1.35897435897436
54,"Lifestealer",107,"Earth Spirit",24,25,49,0.489795918367347,0.628205128205128
54,"Lifestealer",109,"Terrorblade",10,9,19,0.526315789473684,0.243589743589744
54,"Lifestealer",110,"Phoenix",30,26,56,0.535714285714286,0.717948717948718
54,"Lifestealer",111,"Oracle",9,12,21,0.428571428571429,0.269230769230769
54,"Lifestealer",112,"Winter Wyvern",66,58,124,0.532258064516129,1.58974358974359
55,"Dark Seer",56,"Clinkz",39,25,64,0.609375,0.82051282051282
55,"Dark Seer",57,"Omniknight",68,47,115,0.591304347826087,1.47435897435897
55,"Dark Seer",58,"Enchantress",7,14,21,0.333333333333333,0.269230769230769
55,"Dark Seer",59,"Huskar",61,46,107,0.570093457943925,1.37179487179487
55,"Dark Seer",60,"Night Stalker",37,33,70,0.528571428571429,0.897435897435897
55,"Dark Seer",61,"Broodmother",4,10,14,0.285714285714286,0.179487179487179
55,"Dark Seer",62,"Bounty Hunter",131,124,255,0.513725490196078,3.26923076923077
55,"Dark Seer",63,"Weaver",25,29,54,0.462962962962963,0.692307692307692
55,"Dark Seer",64,"Jakiro",42,39,81,0.518518518518518,1.03846153846154
55,"Dark Seer",65,"Batrider",13,6,19,0.684210526315789,0.243589743589744
55,"Dark Seer",66,"Chen",10,6,16,0.625,0.205128205128205
55,"Dark Seer",67,"Spectre",117,96,213,0.549295774647887,2.73076923076923
55,"Dark Seer",68,"Ancient Apparition",114,115,229,0.497816593886463,2.93589743589744
55,"Dark Seer",69,"Doom",83,71,154,0.538961038961039,1.97435897435897
55,"Dark Seer",70,"Ursa",57,52,109,0.522935779816514,1.3974358974359
55,"Dark Seer",71,"Spirit Breaker",146,98,244,0.598360655737705,3.12820512820513
55,"Dark Seer",72,"Gyrocopter",167,174,341,0.489736070381232,4.37179487179487
55,"Dark Seer",73,"Alchemist",178,153,331,0.537764350453172,4.24358974358974
55,"Dark Seer",74,"Invoker",166,155,321,0.517133956386293,4.11538461538461
55,"Dark Seer",75,"Silencer",100,102,202,0.495049504950495,2.58974358974359
55,"Dark Seer",76,"Outworld Devourer",19,26,45,0.422222222222222,0.576923076923077
55,"Dark Seer",77,"Lycan",20,14,34,0.588235294117647,0.435897435897436
55,"Dark Seer",78,"Brewmaster",7,11,18,0.388888888888889,0.230769230769231
55,"Dark Seer",79,"Shadow Demon",18,19,37,0.486486486486487,0.474358974358974
55,"Dark Seer",80,"Lone Druid",5,16,21,0.238095238095238,0.269230769230769
55,"Dark Seer",81,"Chaos Knight",28,29,57,0.491228070175439,0.730769230769231
55,"Dark Seer",82,"Meepo",27,19,46,0.58695652173913,0.58974358974359
55,"Dark Seer",83,"Treant Protector",26,14,40,0.65,0.512820512820513
55,"Dark Seer",84,"Ogre Magi",56,58,114,0.491228070175439,1.46153846153846
55,"Dark Seer",85,"Undying",45,53,98,0.459183673469388,1.25641025641026
55,"Dark Seer",86,"Rubick",113,146,259,0.436293436293436,3.32051282051282
55,"Dark Seer",87,"Disruptor",101,105,206,0.490291262135922,2.64102564102564
55,"Dark Seer",88,"Nyx Assassin",23,23,46,0.5,0.58974358974359
55,"Dark Seer",89,"Naga Siren",12,23,35,0.342857142857143,0.448717948717949
55,"Dark Seer",90,"Keeper of the Light",29,22,51,0.568627450980392,0.653846153846154
55,"Dark Seer",91,"Io",21,37,58,0.362068965517241,0.743589743589744
55,"Dark Seer",92,"Visage",23,21,44,0.522727272727273,0.564102564102564
55,"Dark Seer",93,"Slark",132,131,263,0.501901140684411,3.37179487179487
55,"Dark Seer",94,"Medusa",37,41,78,0.474358974358974,1
55,"Dark Seer",95,"Troll Warlord",23,25,48,0.479166666666667,0.615384615384615
55,"Dark Seer",96,"Centaur Warrunner",10,9,19,0.526315789473684,0.243589743589744
55,"Dark Seer",97,"Magnus",30,39,69,0.434782608695652,0.884615384615385
55,"Dark Seer",98,"Timbersaw",17,15,32,0.53125,0.41025641025641
55,"Dark Seer",99,"Bristleback",29,40,69,0.420289855072464,0.884615384615385
55,"Dark Seer",100,"Tusk",131,98,229,0.572052401746725,2.93589743589744
55,"Dark Seer",101,"Skywrath Mage",37,49,86,0.430232558139535,1.1025641025641
55,"Dark Seer",102,"Abaddon",48,33,81,0.592592592592593,1.03846153846154
55,"Dark Seer",103,"Elder Titan",6,7,13,0.461538461538462,0.166666666666667
55,"Dark Seer",104,"Legion Commander",116,130,246,0.471544715447154,3.15384615384615
55,"Dark Seer",105,"Techies",9,12,21,0.428571428571429,0.269230769230769
55,"Dark Seer",106,"Ember Spirit",148,132,280,0.528571428571429,3.58974358974359
55,"Dark Seer",107,"Earth Spirit",34,23,57,0.596491228070175,0.730769230769231
55,"Dark Seer",109,"Terrorblade",25,27,52,0.480769230769231,0.666666666666667
55,"Dark Seer",110,"Phoenix",22,20,42,0.523809523809524,0.538461538461538
55,"Dark Seer",111,"Oracle",24,16,40,0.6,0.512820512820513
55,"Dark Seer",112,"Winter Wyvern",205,195,400,0.5125,5.12820512820513
56,"Clinkz",57,"Omniknight",50,48,98,0.510204081632653,1.25641025641026
56,"Clinkz",58,"Enchantress",9,8,17,0.529411764705882,0.217948717948718
56,"Clinkz",59,"Huskar",26,33,59,0.440677966101695,0.756410256410256
56,"Clinkz",60,"Night Stalker",26,23,49,0.530612244897959,0.628205128205128
56,"Clinkz",61,"Broodmother",8,15,23,0.347826086956522,0.294871794871795
56,"Clinkz",62,"Bounty Hunter",47,52,99,0.474747474747475,1.26923076923077
56,"Clinkz",63,"Weaver",5,13,18,0.277777777777778,0.230769230769231
56,"Clinkz",64,"Jakiro",26,19,45,0.577777777777778,0.576923076923077
56,"Clinkz",65,"Batrider",11,16,27,0.407407407407407,0.346153846153846
56,"Clinkz",66,"Chen",9,5,14,0.642857142857143,0.179487179487179
56,"Clinkz",67,"Spectre",54,35,89,0.606741573033708,1.14102564102564
56,"Clinkz",68,"Ancient Apparition",62,73,135,0.459259259259259,1.73076923076923
56,"Clinkz",69,"Doom",59,75,134,0.440298507462687,1.71794871794872
56,"Clinkz",70,"Ursa",45,23,68,0.661764705882353,0.871794871794872
56,"Clinkz",71,"Spirit Breaker",56,63,119,0.470588235294118,1.52564102564103
56,"Clinkz",72,"Gyrocopter",32,33,65,0.492307692307692,0.833333333333333
56,"Clinkz",73,"Alchemist",88,84,172,0.511627906976744,2.20512820512821
56,"Clinkz",74,"Invoker",95,110,205,0.463414634146341,2.62820512820513
56,"Clinkz",75,"Silencer",58,60,118,0.491525423728814,1.51282051282051
56,"Clinkz",76,"Outworld Devourer",15,19,34,0.441176470588235,0.435897435897436
56,"Clinkz",77,"Lycan",10,9,19,0.526315789473684,0.243589743589744
56,"Clinkz",78,"Brewmaster",7,10,17,0.411764705882353,0.217948717948718
56,"Clinkz",79,"Shadow Demon",10,15,25,0.4,0.320512820512821
56,"Clinkz",80,"Lone Druid",6,9,15,0.4,0.192307692307692
56,"Clinkz",81,"Chaos Knight",11,13,24,0.458333333333333,0.307692307692308
56,"Clinkz",82,"Meepo",11,17,28,0.392857142857143,0.358974358974359
56,"Clinkz",83,"Treant Protector",28,28,56,0.5,0.717948717948718
56,"Clinkz",84,"Ogre Magi",57,62,119,0.478991596638655,1.52564102564103
56,"Clinkz",85,"Undying",65,57,122,0.532786885245902,1.56410256410256
56,"Clinkz",86,"Rubick",75,83,158,0.474683544303797,2.02564102564103
56,"Clinkz",87,"Disruptor",44,47,91,0.483516483516484,1.16666666666667
56,"Clinkz",88,"Nyx Assassin",14,21,35,0.4,0.448717948717949
56,"Clinkz",89,"Naga Siren",12,7,19,0.631578947368421,0.243589743589744
56,"Clinkz",90,"Keeper of the Light",15,25,40,0.375,0.512820512820513
56,"Clinkz",91,"Io",8,17,25,0.32,0.320512820512821
56,"Clinkz",92,"Visage",7,8,15,0.466666666666667,0.192307692307692
56,"Clinkz",93,"Slark",33,56,89,0.370786516853933,1.14102564102564
56,"Clinkz",94,"Medusa",16,17,33,0.484848484848485,0.423076923076923
56,"Clinkz",95,"Troll Warlord",13,12,25,0.52,0.320512820512821
56,"Clinkz",96,"Centaur Warrunner",19,15,34,0.558823529411765,0.435897435897436
56,"Clinkz",97,"Magnus",21,33,54,0.388888888888889,0.692307692307692
56,"Clinkz",98,"Timbersaw",20,25,45,0.444444444444444,0.576923076923077
56,"Clinkz",99,"Bristleback",25,32,57,0.43859649122807,0.730769230769231
56,"Clinkz",100,"Tusk",97,95,192,0.505208333333333,2.46153846153846
56,"Clinkz",101,"Skywrath Mage",20,36,56,0.357142857142857,0.717948717948718
56,"Clinkz",102,"Abaddon",34,30,64,0.53125,0.82051282051282
56,"Clinkz",103,"Elder Titan",6,9,15,0.4,0.192307692307692
56,"Clinkz",104,"Legion Commander",80,97,177,0.451977401129944,2.26923076923077
56,"Clinkz",105,"Techies",8,14,22,0.363636363636364,0.282051282051282
56,"Clinkz",106,"Ember Spirit",54,52,106,0.509433962264151,1.35897435897436
56,"Clinkz",107,"Earth Spirit",26,29,55,0.472727272727273,0.705128205128205
56,"Clinkz",109,"Terrorblade",13,16,29,0.448275862068966,0.371794871794872
56,"Clinkz",110,"Phoenix",28,24,52,0.538461538461538,0.666666666666667
56,"Clinkz",111,"Oracle",4,8,12,0.333333333333333,0.153846153846154
56,"Clinkz",112,"Winter Wyvern",75,61,136,0.551470588235294,1.74358974358974
57,"Omniknight",58,"Enchantress",22,14,36,0.611111111111111,0.461538461538462
57,"Omniknight",59,"Huskar",118,70,188,0.627659574468085,2.41025641025641
57,"Omniknight",60,"Night Stalker",50,34,84,0.595238095238095,1.07692307692308
57,"Omniknight",61,"Broodmother",23,27,50,0.46,0.641025641025641
57,"Omniknight",62,"Bounty Hunter",103,91,194,0.530927835051546,2.48717948717949
57,"Omniknight",63,"Weaver",59,47,106,0.556603773584906,1.35897435897436
57,"Omniknight",64,"Jakiro",52,23,75,0.693333333333333,0.961538461538462
57,"Omniknight",65,"Batrider",26,20,46,0.565217391304348,0.58974358974359
57,"Omniknight",66,"Chen",7,5,12,0.583333333333333,0.153846153846154
57,"Omniknight",67,"Spectre",173,100,273,0.633699633699634,3.5
57,"Omniknight",68,"Ancient Apparition",64,57,121,0.528925619834711,1.55128205128205
57,"Omniknight",69,"Doom",141,97,238,0.592436974789916,3.05128205128205
57,"Omniknight",70,"Ursa",127,59,186,0.682795698924731,2.38461538461538
57,"Omniknight",71,"Spirit Breaker",157,77,234,0.670940170940171,3
57,"Omniknight",72,"Gyrocopter",164,118,282,0.581560283687943,3.61538461538462
57,"Omniknight",73,"Alchemist",267,158,425,0.628235294117647,5.44871794871795
57,"Omniknight",74,"Invoker",264,208,472,0.559322033898305,6.05128205128205
57,"Omniknight",75,"Silencer",127,79,206,0.616504854368932,2.64102564102564
57,"Omniknight",76,"Outworld Devourer",35,31,66,0.53030303030303,0.846153846153846
57,"Omniknight",77,"Lycan",31,13,44,0.704545454545455,0.564102564102564
57,"Omniknight",78,"Brewmaster",19,14,33,0.575757575757576,0.423076923076923
57,"Omniknight",79,"Shadow Demon",20,17,37,0.540540540540541,0.474358974358974
57,"Omniknight",80,"Lone Druid",17,14,31,0.548387096774194,0.397435897435897
57,"Omniknight",81,"Chaos Knight",57,36,93,0.612903225806452,1.19230769230769
57,"Omniknight",82,"Meepo",42,38,80,0.525,1.02564102564103
57,"Omniknight",83,"Treant Protector",24,13,37,0.648648648648649,0.474358974358974
57,"Omniknight",84,"Ogre Magi",51,38,89,0.573033707865168,1.14102564102564
57,"Omniknight",85,"Undying",106,44,150,0.706666666666667,1.92307692307692
57,"Omniknight",86,"Rubick",98,90,188,0.521276595744681,2.41025641025641
57,"Omniknight",87,"Disruptor",64,43,107,0.598130841121495,1.37179487179487
57,"Omniknight",88,"Nyx Assassin",65,29,94,0.691489361702128,1.20512820512821
57,"Omniknight",89,"Naga Siren",11,13,24,0.458333333333333,0.307692307692308
57,"Omniknight",90,"Keeper of the Light",26,27,53,0.490566037735849,0.67948717948718
57,"Omniknight",91,"Io",19,11,30,0.633333333333333,0.384615384615385
57,"Omniknight",92,"Visage",16,11,27,0.592592592592593,0.346153846153846
57,"Omniknight",93,"Slark",204,142,346,0.589595375722543,4.43589743589744
57,"Omniknight",94,"Medusa",62,47,109,0.568807339449541,1.3974358974359
57,"Omniknight",95,"Troll Warlord",43,49,92,0.467391304347826,1.17948717948718
57,"Omniknight",96,"Centaur Warrunner",51,28,79,0.645569620253165,1.01282051282051
57,"Omniknight",97,"Magnus",72,58,130,0.553846153846154,1.66666666666667
57,"Omniknight",98,"Timbersaw",62,49,111,0.558558558558559,1.42307692307692
57,"Omniknight",99,"Bristleback",97,77,174,0.557471264367816,2.23076923076923
57,"Omniknight",100,"Tusk",199,147,346,0.57514450867052,4.43589743589744
57,"Omniknight",101,"Skywrath Mage",38,34,72,0.527777777777778,0.923076923076923
57,"Omniknight",102,"Abaddon",66,41,107,0.616822429906542,1.37179487179487
57,"Omniknight",103,"Elder Titan",15,7,22,0.681818181818182,0.282051282051282
57,"Omniknight",104,"Legion Commander",229,167,396,0.578282828282828,5.07692307692308
57,"Omniknight",105,"Techies",23,8,31,0.741935483870968,0.397435897435897
57,"Omniknight",106,"Ember Spirit",161,123,284,0.566901408450704,3.64102564102564
57,"Omniknight",107,"Earth Spirit",45,23,68,0.661764705882353,0.871794871794872
57,"Omniknight",109,"Terrorblade",39,29,68,0.573529411764706,0.871794871794872
57,"Omniknight",110,"Phoenix",37,27,64,0.578125,0.82051282051282
57,"Omniknight",111,"Oracle",15,11,26,0.576923076923077,0.333333333333333
57,"Omniknight",112,"Winter Wyvern",88,54,142,0.619718309859155,1.82051282051282
58,"Enchantress",59,"Huskar",12,19,31,0.387096774193548,0.397435897435897
58,"Enchantress",60,"Night Stalker",6,19,25,0.24,0.320512820512821
58,"Enchantress",61,"Broodmother",4,6,10,0.4,0.128205128205128
58,"Enchantress",62,"Bounty Hunter",13,18,31,0.419354838709677,0.397435897435897
58,"Enchantress",63,"Weaver",7,9,16,0.4375,0.205128205128205
58,"Enchantress",64,"Jakiro",9,4,13,0.692307692307692,0.166666666666667
58,"Enchantress",65,"Batrider",4,6,10,0.4,0.128205128205128
58,"Enchantress",66,"Chen",4,0,4,1,0.0512820512820513
58,"Enchantress",67,"Spectre",34,23,57,0.596491228070175,0.730769230769231
58,"Enchantress",68,"Ancient Apparition",19,25,44,0.431818181818182,0.564102564102564
58,"Enchantress",69,"Doom",22,25,47,0.468085106382979,0.602564102564103
58,"Enchantress",70,"Ursa",8,15,23,0.347826086956522,0.294871794871795
58,"Enchantress",71,"Spirit Breaker",15,35,50,0.3,0.641025641025641
58,"Enchantress",72,"Gyrocopter",16,35,51,0.313725490196078,0.653846153846154
58,"Enchantress",73,"Alchemist",29,43,72,0.402777777777778,0.923076923076923
58,"Enchantress",74,"Invoker",33,42,75,0.44,0.961538461538462
58,"Enchantress",75,"Silencer",20,28,48,0.416666666666667,0.615384615384615
58,"Enchantress",76,"Outworld Devourer",6,6,12,0.5,0.153846153846154
58,"Enchantress",77,"Lycan",3,3,6,0.5,0.0769230769230769
58,"Enchantress",78,"Brewmaster",1,1,2,0.5,0.0256410256410256
58,"Enchantress",79,"Shadow Demon",2,5,7,0.285714285714286,0.0897435897435897
58,"Enchantress",80,"Lone Druid",1,1,2,0.5,0.0256410256410256
58,"Enchantress",81,"Chaos Knight",9,9,18,0.5,0.230769230769231
58,"Enchantress",82,"Meepo",3,9,12,0.25,0.153846153846154
58,"Enchantress",83,"Treant Protector",2,8,10,0.2,0.128205128205128
58,"Enchantress",84,"Ogre Magi",13,21,34,0.382352941176471,0.435897435897436
58,"Enchantress",85,"Undying",15,15,30,0.5,0.384615384615385
58,"Enchantress",86,"Rubick",28,47,75,0.373333333333333,0.961538461538462
58,"Enchantress",87,"Disruptor",16,5,21,0.761904761904762,0.269230769230769
58,"Enchantress",88,"Nyx Assassin",9,7,16,0.5625,0.205128205128205
58,"Enchantress",89,"Naga Siren",1,6,7,0.142857142857143,0.0897435897435897
58,"Enchantress",90,"Keeper of the Light",5,14,19,0.263157894736842,0.243589743589744
58,"Enchantress",91,"Io",7,3,10,0.7,0.128205128205128
58,"Enchantress",92,"Visage",4,3,7,0.571428571428571,0.0897435897435897
58,"Enchantress",93,"Slark",29,44,73,0.397260273972603,0.935897435897436
58,"Enchantress",94,"Medusa",9,11,20,0.45,0.256410256410256
58,"Enchantress",95,"Troll Warlord",10,7,17,0.588235294117647,0.217948717948718
58,"Enchantress",96,"Centaur Warrunner",8,7,15,0.533333333333333,0.192307692307692
58,"Enchantress",97,"Magnus",10,20,30,0.333333333333333,0.384615384615385
58,"Enchantress",98,"Timbersaw",8,17,25,0.32,0.320512820512821
58,"Enchantress",99,"Bristleback",8,19,27,0.296296296296296,0.346153846153846
58,"Enchantress",100,"Tusk",15,37,52,0.288461538461538,0.666666666666667
58,"Enchantress",101,"Skywrath Mage",11,15,26,0.423076923076923,0.333333333333333
58,"Enchantress",102,"Abaddon",13,18,31,0.419354838709677,0.397435897435897
58,"Enchantress",103,"Elder Titan",0,5,5,0,0.0641025641025641
58,"Enchantress",104,"Legion Commander",18,32,50,0.36,0.641025641025641
58,"Enchantress",105,"Techies",3,5,8,0.375,0.102564102564103
58,"Enchantress",106,"Ember Spirit",34,38,72,0.472222222222222,0.923076923076923
58,"Enchantress",107,"Earth Spirit",10,10,20,0.5,0.256410256410256
58,"Enchantress",109,"Terrorblade",4,10,14,0.285714285714286,0.179487179487179
58,"Enchantress",110,"Phoenix",14,7,21,0.666666666666667,0.269230769230769
58,"Enchantress",111,"Oracle",2,6,8,0.25,0.102564102564103
58,"Enchantress",112,"Winter Wyvern",19,21,40,0.475,0.512820512820513
59,"Huskar",60,"Night Stalker",42,31,73,0.575342465753425,0.935897435897436
59,"Huskar",61,"Broodmother",13,25,38,0.342105263157895,0.487179487179487
59,"Huskar",62,"Bounty Hunter",86,96,182,0.472527472527473,2.33333333333333
59,"Huskar",63,"Weaver",22,40,62,0.354838709677419,0.794871794871795
59,"Huskar",64,"Jakiro",28,37,65,0.430769230769231,0.833333333333333
59,"Huskar",65,"Batrider",10,15,25,0.4,0.320512820512821
59,"Huskar",66,"Chen",16,7,23,0.695652173913043,0.294871794871795
59,"Huskar",67,"Spectre",67,71,138,0.485507246376812,1.76923076923077
59,"Huskar",68,"Ancient Apparition",83,78,161,0.515527950310559,2.06410256410256
59,"Huskar",69,"Doom",78,72,150,0.52,1.92307692307692
59,"Huskar",70,"Ursa",42,44,86,0.488372093023256,1.1025641025641
59,"Huskar",71,"Spirit Breaker",115,78,193,0.595854922279793,2.47435897435897
59,"Huskar",72,"Gyrocopter",71,62,133,0.533834586466165,1.70512820512821
59,"Huskar",73,"Alchemist",132,117,249,0.530120481927711,3.19230769230769
59,"Huskar",74,"Invoker",116,120,236,0.491525423728814,3.02564102564103
59,"Huskar",75,"Silencer",107,102,209,0.511961722488038,2.67948717948718
59,"Huskar",76,"Outworld Devourer",19,20,39,0.487179487179487,0.5
59,"Huskar",77,"Lycan",15,13,28,0.535714285714286,0.358974358974359
59,"Huskar",78,"Brewmaster",6,14,20,0.3,0.256410256410256
59,"Huskar",79,"Shadow Demon",13,27,40,0.325,0.512820512820513
59,"Huskar",80,"Lone Druid",8,15,23,0.347826086956522,0.294871794871795
59,"Huskar",81,"Chaos Knight",19,25,44,0.431818181818182,0.564102564102564
59,"Huskar",82,"Meepo",22,25,47,0.468085106382979,0.602564102564103
59,"Huskar",83,"Treant Protector",26,30,56,0.464285714285714,0.717948717948718
59,"Huskar",84,"Ogre Magi",57,67,124,0.459677419354839,1.58974358974359
59,"Huskar",85,"Undying",82,78,160,0.5125,2.05128205128205
59,"Huskar",86,"Rubick",89,115,204,0.436274509803922,2.61538461538462
59,"Huskar",87,"Disruptor",59,61,120,0.491666666666667,1.53846153846154
59,"Huskar",88,"Nyx Assassin",31,39,70,0.442857142857143,0.897435897435897
59,"Huskar",89,"Naga Siren",9,16,25,0.36,0.320512820512821
59,"Huskar",90,"Keeper of the Light",29,28,57,0.508771929824561,0.730769230769231
59,"Huskar",91,"Io",31,32,63,0.492063492063492,0.807692307692308
59,"Huskar",92,"Visage",16,13,29,0.551724137931034,0.371794871794872
59,"Huskar",93,"Slark",74,77,151,0.490066225165563,1.93589743589744
59,"Huskar",94,"Medusa",29,32,61,0.475409836065574,0.782051282051282
59,"Huskar",95,"Troll Warlord",24,28,52,0.461538461538462,0.666666666666667
59,"Huskar",96,"Centaur Warrunner",22,29,51,0.431372549019608,0.653846153846154
59,"Huskar",97,"Magnus",30,25,55,0.545454545454545,0.705128205128205
59,"Huskar",98,"Timbersaw",26,28,54,0.481481481481481,0.692307692307692
59,"Huskar",99,"Bristleback",44,52,96,0.458333333333333,1.23076923076923
59,"Huskar",100,"Tusk",139,132,271,0.512915129151292,3.47435897435897
59,"Huskar",101,"Skywrath Mage",30,49,79,0.379746835443038,1.01282051282051
59,"Huskar",102,"Abaddon",62,37,99,0.626262626262626,1.26923076923077
59,"Huskar",103,"Elder Titan",10,13,23,0.434782608695652,0.294871794871795
59,"Huskar",104,"Legion Commander",100,133,233,0.429184549356223,2.98717948717949
59,"Huskar",105,"Techies",18,20,38,0.473684210526316,0.487179487179487
59,"Huskar",106,"Ember Spirit",66,90,156,0.423076923076923,2
59,"Huskar",107,"Earth Spirit",30,25,55,0.545454545454545,0.705128205128205
59,"Huskar",109,"Terrorblade",10,13,23,0.434782608695652,0.294871794871795
59,"Huskar",110,"Phoenix",47,42,89,0.528089887640449,1.14102564102564
59,"Huskar",111,"Oracle",27,27,54,0.5,0.692307692307692
59,"Huskar",112,"Winter Wyvern",120,94,214,0.560747663551402,2.74358974358974
60,"Night Stalker",61,"Broodmother",9,8,17,0.529411764705882,0.217948717948718
60,"Night Stalker",62,"Bounty Hunter",63,71,134,0.470149253731343,1.71794871794872
60,"Night Stalker",63,"Weaver",20,32,52,0.384615384615385,0.666666666666667
60,"Night Stalker",64,"Jakiro",36,32,68,0.529411764705882,0.871794871794872
60,"Night Stalker",65,"Batrider",6,10,16,0.375,0.205128205128205
60,"Night Stalker",66,"Chen",7,5,12,0.583333333333333,0.153846153846154
60,"Night Stalker",67,"Spectre",75,54,129,0.581395348837209,1.65384615384615
60,"Night Stalker",68,"Ancient Apparition",85,80,165,0.515151515151515,2.11538461538462
60,"Night Stalker",69,"Doom",74,59,133,0.556390977443609,1.70512820512821
60,"Night Stalker",70,"Ursa",46,31,77,0.597402597402597,0.987179487179487
60,"Night Stalker",71,"Spirit Breaker",63,67,130,0.484615384615385,1.66666666666667
60,"Night Stalker",72,"Gyrocopter",92,89,181,0.50828729281768,2.32051282051282
60,"Night Stalker",73,"Alchemist",126,83,209,0.602870813397129,2.67948717948718
60,"Night Stalker",74,"Invoker",120,108,228,0.526315789473684,2.92307692307692
60,"Night Stalker",75,"Silencer",84,63,147,0.571428571428571,1.88461538461538
60,"Night Stalker",76,"Outworld Devourer",18,17,35,0.514285714285714,0.448717948717949
60,"Night Stalker",77,"Lycan",11,13,24,0.458333333333333,0.307692307692308
60,"Night Stalker",78,"Brewmaster",9,7,16,0.5625,0.205128205128205
60,"Night Stalker",79,"Shadow Demon",14,18,32,0.4375,0.41025641025641
60,"Night Stalker",80,"Lone Druid",9,12,21,0.428571428571429,0.269230769230769
60,"Night Stalker",81,"Chaos Knight",11,25,36,0.305555555555556,0.461538461538462
60,"Night Stalker",82,"Meepo",16,18,34,0.470588235294118,0.435897435897436
60,"Night Stalker",83,"Treant Protector",21,18,39,0.538461538461538,0.5
60,"Night Stalker",84,"Ogre Magi",37,47,84,0.44047619047619,1.07692307692308
60,"Night Stalker",85,"Undying",55,49,104,0.528846153846154,1.33333333333333
60,"Night Stalker",86,"Rubick",79,101,180,0.438888888888889,2.30769230769231
60,"Night Stalker",87,"Disruptor",57,66,123,0.463414634146341,1.57692307692308
60,"Night Stalker",88,"Nyx Assassin",30,19,49,0.612244897959184,0.628205128205128
60,"Night Stalker",89,"Naga Siren",12,12,24,0.5,0.307692307692308
60,"Night Stalker",90,"Keeper of the Light",22,29,51,0.431372549019608,0.653846153846154
60,"Night Stalker",91,"Io",9,16,25,0.36,0.320512820512821
60,"Night Stalker",92,"Visage",12,12,24,0.5,0.307692307692308
60,"Night Stalker",93,"Slark",86,97,183,0.469945355191257,2.34615384615385
60,"Night Stalker",94,"Medusa",31,22,53,0.584905660377358,0.67948717948718
60,"Night Stalker",95,"Troll Warlord",17,21,38,0.447368421052632,0.487179487179487
60,"Night Stalker",96,"Centaur Warrunner",11,13,24,0.458333333333333,0.307692307692308
60,"Night Stalker",97,"Magnus",22,29,51,0.431372549019608,0.653846153846154
60,"Night Stalker",98,"Timbersaw",11,28,39,0.282051282051282,0.5
60,"Night Stalker",99,"Bristleback",29,39,68,0.426470588235294,0.871794871794872
60,"Night Stalker",100,"Tusk",83,100,183,0.453551912568306,2.34615384615385
60,"Night Stalker",101,"Skywrath Mage",41,40,81,0.506172839506173,1.03846153846154
60,"Night Stalker",102,"Abaddon",35,23,58,0.603448275862069,0.743589743589744
60,"Night Stalker",103,"Elder Titan",5,5,10,0.5,0.128205128205128
60,"Night Stalker",104,"Legion Commander",70,86,156,0.448717948717949,2
60,"Night Stalker",105,"Techies",13,13,26,0.5,0.333333333333333
60,"Night Stalker",106,"Ember Spirit",72,89,161,0.447204968944099,2.06410256410256
60,"Night Stalker",107,"Earth Spirit",27,20,47,0.574468085106383,0.602564102564103
60,"Night Stalker",109,"Terrorblade",24,15,39,0.615384615384615,0.5
60,"Night Stalker",110,"Phoenix",33,27,60,0.55,0.769230769230769
60,"Night Stalker",111,"Oracle",12,7,19,0.631578947368421,0.243589743589744
60,"Night Stalker",112,"Winter Wyvern",93,79,172,0.540697674418605,2.20512820512821
61,"Broodmother",62,"Bounty Hunter",16,44,60,0.266666666666667,0.769230769230769
61,"Broodmother",63,"Weaver",8,14,22,0.363636363636364,0.282051282051282
61,"Broodmother",64,"Jakiro",15,11,26,0.576923076923077,0.333333333333333
61,"Broodmother",65,"Batrider",2,7,9,0.222222222222222,0.115384615384615
61,"Broodmother",66,"Chen",3,6,9,0.333333333333333,0.115384615384615
61,"Broodmother",67,"Spectre",33,31,64,0.515625,0.82051282051282
61,"Broodmother",68,"Ancient Apparition",30,36,66,0.454545454545455,0.846153846153846
61,"Broodmother",69,"Doom",40,32,72,0.555555555555556,0.923076923076923
61,"Broodmother",70,"Ursa",30,25,55,0.545454545454545,0.705128205128205
61,"Broodmother",71,"Spirit Breaker",22,25,47,0.468085106382979,0.602564102564103
61,"Broodmother",72,"Gyrocopter",26,49,75,0.346666666666667,0.961538461538462
61,"Broodmother",73,"Alchemist",41,64,105,0.39047619047619,1.34615384615385
61,"Broodmother",74,"Invoker",49,85,134,0.365671641791045,1.71794871794872
61,"Broodmother",75,"Silencer",30,39,69,0.434782608695652,0.884615384615385
61,"Broodmother",76,"Outworld Devourer",13,10,23,0.565217391304348,0.294871794871795
61,"Broodmother",77,"Lycan",8,9,17,0.470588235294118,0.217948717948718
61,"Broodmother",78,"Brewmaster",4,4,8,0.5,0.102564102564103
61,"Broodmother",79,"Shadow Demon",4,13,17,0.235294117647059,0.217948717948718
61,"Broodmother",80,"Lone Druid",1,2,3,0.333333333333333,0.0384615384615385
61,"Broodmother",81,"Chaos Knight",9,9,18,0.5,0.230769230769231
61,"Broodmother",82,"Meepo",7,7,14,0.5,0.179487179487179
61,"Broodmother",83,"Treant Protector",5,13,18,0.277777777777778,0.230769230769231
61,"Broodmother",84,"Ogre Magi",22,24,46,0.478260869565217,0.58974358974359
61,"Broodmother",85,"Undying",12,15,27,0.444444444444444,0.346153846153846
61,"Broodmother",86,"Rubick",41,68,109,0.376146788990826,1.3974358974359
61,"Broodmother",87,"Disruptor",28,28,56,0.5,0.717948717948718
61,"Broodmother",88,"Nyx Assassin",10,17,27,0.37037037037037,0.346153846153846
61,"Broodmother",89,"Naga Siren",0,6,6,0,0.0769230769230769
61,"Broodmother",90,"Keeper of the Light",10,19,29,0.344827586206897,0.371794871794872
61,"Broodmother",91,"Io",7,7,14,0.5,0.179487179487179
61,"Broodmother",92,"Visage",5,10,15,0.333333333333333,0.192307692307692
61,"Broodmother",93,"Slark",32,55,87,0.367816091954023,1.11538461538462
61,"Broodmother",94,"Medusa",8,15,23,0.347826086956522,0.294871794871795
61,"Broodmother",95,"Troll Warlord",6,10,16,0.375,0.205128205128205
61,"Broodmother",96,"Centaur Warrunner",7,5,12,0.583333333333333,0.153846153846154
61,"Broodmother",97,"Magnus",11,12,23,0.478260869565217,0.294871794871795
61,"Broodmother",98,"Timbersaw",4,8,12,0.333333333333333,0.153846153846154
61,"Broodmother",99,"Bristleback",4,16,20,0.2,0.256410256410256
61,"Broodmother",100,"Tusk",29,51,80,0.3625,1.02564102564103
61,"Broodmother",101,"Skywrath Mage",11,19,30,0.366666666666667,0.384615384615385
61,"Broodmother",102,"Abaddon",15,17,32,0.46875,0.41025641025641
61,"Broodmother",103,"Elder Titan",3,3,6,0.5,0.0769230769230769
61,"Broodmother",104,"Legion Commander",42,67,109,0.385321100917431,1.3974358974359
61,"Broodmother",105,"Techies",5,5,10,0.5,0.128205128205128
61,"Broodmother",106,"Ember Spirit",39,52,91,0.428571428571429,1.16666666666667
61,"Broodmother",107,"Earth Spirit",10,14,24,0.416666666666667,0.307692307692308
61,"Broodmother",109,"Terrorblade",7,8,15,0.466666666666667,0.192307692307692
61,"Broodmother",110,"Phoenix",6,7,13,0.461538461538462,0.166666666666667
61,"Broodmother",111,"Oracle",2,3,5,0.4,0.0641025641025641
61,"Broodmother",112,"Winter Wyvern",35,36,71,0.492957746478873,0.91025641025641
62,"Bounty Hunter",63,"Weaver",39,72,111,0.351351351351351,1.42307692307692
62,"Bounty Hunter",64,"Jakiro",45,48,93,0.483870967741935,1.19230769230769
62,"Bounty Hunter",65,"Batrider",19,25,44,0.431818181818182,0.564102564102564
62,"Bounty Hunter",66,"Chen",3,5,8,0.375,0.102564102564103
62,"Bounty Hunter",67,"Spectre",247,144,391,0.631713554987212,5.01282051282051
62,"Bounty Hunter",68,"Ancient Apparition",125,133,258,0.484496124031008,3.30769230769231
62,"Bounty Hunter",69,"Doom",187,159,346,0.540462427745665,4.43589743589744
62,"Bounty Hunter",70,"Ursa",88,81,169,0.520710059171598,2.16666666666667
62,"Bounty Hunter",71,"Spirit Breaker",156,154,310,0.503225806451613,3.97435897435897
62,"Bounty Hunter",72,"Gyrocopter",176,187,363,0.484848484848485,4.65384615384615
62,"Bounty Hunter",73,"Alchemist",292,262,554,0.527075812274368,7.1025641025641
62,"Bounty Hunter",74,"Invoker",342,322,664,0.515060240963855,8.51282051282051
62,"Bounty Hunter",75,"Silencer",171,177,348,0.491379310344828,4.46153846153846
62,"Bounty Hunter",76,"Outworld Devourer",39,41,80,0.4875,1.02564102564103
62,"Bounty Hunter",77,"Lycan",24,16,40,0.6,0.512820512820513
62,"Bounty Hunter",78,"Brewmaster",26,18,44,0.590909090909091,0.564102564102564
62,"Bounty Hunter",79,"Shadow Demon",21,34,55,0.381818181818182,0.705128205128205
62,"Bounty Hunter",80,"Lone Druid",17,23,40,0.425,0.512820512820513
62,"Bounty Hunter",81,"Chaos Knight",44,58,102,0.431372549019608,1.30769230769231
62,"Bounty Hunter",82,"Meepo",40,42,82,0.48780487804878,1.05128205128205
62,"Bounty Hunter",83,"Treant Protector",28,38,66,0.424242424242424,0.846153846153846
62,"Bounty Hunter",84,"Ogre Magi",75,73,148,0.506756756756757,1.8974358974359
62,"Bounty Hunter",85,"Undying",98,91,189,0.518518518518518,2.42307692307692
62,"Bounty Hunter",86,"Rubick",153,190,343,0.446064139941691,4.3974358974359
62,"Bounty Hunter",87,"Disruptor",99,99,198,0.5,2.53846153846154
62,"Bounty Hunter",88,"Nyx Assassin",40,50,90,0.444444444444444,1.15384615384615
62,"Bounty Hunter",89,"Naga Siren",20,19,39,0.512820512820513,0.5
62,"Bounty Hunter",90,"Keeper of the Light",43,41,84,0.511904761904762,1.07692307692308
62,"Bounty Hunter",91,"Io",28,27,55,0.509090909090909,0.705128205128205
62,"Bounty Hunter",92,"Visage",17,19,36,0.472222222222222,0.461538461538462
62,"Bounty Hunter",93,"Slark",214,245,459,0.466230936819172,5.88461538461539
62,"Bounty Hunter",94,"Medusa",67,55,122,0.549180327868853,1.56410256410256
62,"Bounty Hunter",95,"Troll Warlord",46,42,88,0.522727272727273,1.12820512820513
62,"Bounty Hunter",96,"Centaur Warrunner",47,44,91,0.516483516483517,1.16666666666667
62,"Bounty Hunter",97,"Magnus",77,90,167,0.461077844311377,2.14102564102564
62,"Bounty Hunter",98,"Timbersaw",68,69,137,0.496350364963504,1.75641025641026
62,"Bounty Hunter",99,"Bristleback",103,113,216,0.476851851851852,2.76923076923077
62,"Bounty Hunter",100,"Tusk",186,204,390,0.476923076923077,5
62,"Bounty Hunter",101,"Skywrath Mage",53,81,134,0.395522388059701,1.71794871794872
62,"Bounty Hunter",102,"Abaddon",84,56,140,0.6,1.79487179487179
62,"Bounty Hunter",103,"Elder Titan",26,8,34,0.764705882352941,0.435897435897436
62,"Bounty Hunter",104,"Legion Commander",174,222,396,0.439393939393939,5.07692307692308
62,"Bounty Hunter",105,"Techies",9,19,28,0.321428571428571,0.358974358974359
62,"Bounty Hunter",106,"Ember Spirit",201,221,422,0.476303317535545,5.41025641025641
62,"Bounty Hunter",107,"Earth Spirit",70,64,134,0.522388059701492,1.71794871794872
62,"Bounty Hunter",109,"Terrorblade",49,42,91,0.538461538461538,1.16666666666667
62,"Bounty Hunter",110,"Phoenix",94,66,160,0.5875,2.05128205128205
62,"Bounty Hunter",111,"Oracle",29,21,50,0.58,0.641025641025641
62,"Bounty Hunter",112,"Winter Wyvern",180,163,343,0.524781341107872,4.3974358974359
63,"Weaver",64,"Jakiro",19,37,56,0.339285714285714,0.717948717948718
63,"Weaver",65,"Batrider",7,16,23,0.304347826086957,0.294871794871795
63,"Weaver",66,"Chen",5,7,12,0.416666666666667,0.153846153846154
63,"Weaver",67,"Spectre",44,33,77,0.571428571428571,0.987179487179487
63,"Weaver",68,"Ancient Apparition",54,77,131,0.412213740458015,1.67948717948718
63,"Weaver",69,"Doom",49,57,106,0.462264150943396,1.35897435897436
63,"Weaver",70,"Ursa",36,34,70,0.514285714285714,0.897435897435897
63,"Weaver",71,"Spirit Breaker",66,61,127,0.519685039370079,1.62820512820513
63,"Weaver",72,"Gyrocopter",44,51,95,0.463157894736842,1.21794871794872
63,"Weaver",73,"Alchemist",121,83,204,0.593137254901961,2.61538461538462
63,"Weaver",74,"Invoker",76,120,196,0.387755102040816,2.51282051282051
63,"Weaver",75,"Silencer",67,79,146,0.458904109589041,1.87179487179487
63,"Weaver",76,"Outworld Devourer",13,15,28,0.464285714285714,0.358974358974359
63,"Weaver",77,"Lycan",7,9,16,0.4375,0.205128205128205
63,"Weaver",78,"Brewmaster",6,6,12,0.5,0.153846153846154
63,"Weaver",79,"Shadow Demon",5,16,21,0.238095238095238,0.269230769230769
63,"Weaver",80,"Lone Druid",4,9,13,0.307692307692308,0.166666666666667
63,"Weaver",81,"Chaos Knight",27,29,56,0.482142857142857,0.717948717948718
63,"Weaver",82,"Meepo",9,14,23,0.391304347826087,0.294871794871795
63,"Weaver",83,"Treant Protector",18,21,39,0.461538461538462,0.5
63,"Weaver",84,"Ogre Magi",48,54,102,0.470588235294118,1.30769230769231
63,"Weaver",85,"Undying",60,60,120,0.5,1.53846153846154
63,"Weaver",86,"Rubick",61,107,168,0.363095238095238,2.15384615384615
63,"Weaver",87,"Disruptor",39,50,89,0.438202247191011,1.14102564102564
63,"Weaver",88,"Nyx Assassin",12,23,35,0.342857142857143,0.448717948717949
63,"Weaver",89,"Naga Siren",6,14,20,0.3,0.256410256410256
63,"Weaver",90,"Keeper of the Light",19,26,45,0.422222222222222,0.576923076923077
63,"Weaver",91,"Io",15,23,38,0.394736842105263,0.487179487179487
63,"Weaver",92,"Visage",7,8,15,0.466666666666667,0.192307692307692
63,"Weaver",93,"Slark",50,64,114,0.43859649122807,1.46153846153846
63,"Weaver",94,"Medusa",15,26,41,0.365853658536585,0.525641025641026
63,"Weaver",95,"Troll Warlord",12,16,28,0.428571428571429,0.358974358974359
63,"Weaver",96,"Centaur Warrunner",14,9,23,0.608695652173913,0.294871794871795
63,"Weaver",97,"Magnus",16,27,43,0.372093023255814,0.551282051282051
63,"Weaver",98,"Timbersaw",14,18,32,0.4375,0.41025641025641
63,"Weaver",99,"Bristleback",20,37,57,0.350877192982456,0.730769230769231
63,"Weaver",100,"Tusk",66,94,160,0.4125,2.05128205128205
63,"Weaver",101,"Skywrath Mage",17,33,50,0.34,0.641025641025641
63,"Weaver",102,"Abaddon",49,34,83,0.590361445783133,1.06410256410256
63,"Weaver",103,"Elder Titan",11,6,17,0.647058823529412,0.217948717948718
63,"Weaver",104,"Legion Commander",80,104,184,0.434782608695652,2.35897435897436
63,"Weaver",105,"Techies",8,13,21,0.380952380952381,0.269230769230769
63,"Weaver",106,"Ember Spirit",49,65,114,0.429824561403509,1.46153846153846
63,"Weaver",107,"Earth Spirit",20,24,44,0.454545454545455,0.564102564102564
63,"Weaver",109,"Terrorblade",13,11,24,0.541666666666667,0.307692307692308
63,"Weaver",110,"Phoenix",19,15,34,0.558823529411765,0.435897435897436
63,"Weaver",111,"Oracle",10,11,21,0.476190476190476,0.269230769230769
63,"Weaver",112,"Winter Wyvern",58,65,123,0.471544715447154,1.57692307692308
64,"Jakiro",65,"Batrider",10,17,27,0.37037037037037,0.346153846153846
64,"Jakiro",66,"Chen",7,6,13,0.538461538461538,0.166666666666667
64,"Jakiro",67,"Spectre",89,56,145,0.613793103448276,1.85897435897436
64,"Jakiro",68,"Ancient Apparition",39,32,71,0.549295774647887,0.91025641025641
64,"Jakiro",69,"Doom",84,61,145,0.579310344827586,1.85897435897436
64,"Jakiro",70,"Ursa",43,26,69,0.623188405797101,0.884615384615385
64,"Jakiro",71,"Spirit Breaker",73,66,139,0.525179856115108,1.78205128205128
64,"Jakiro",72,"Gyrocopter",87,76,163,0.533742331288344,2.08974358974359
64,"Jakiro",73,"Alchemist",107,116,223,0.479820627802691,2.85897435897436
64,"Jakiro",74,"Invoker",129,123,252,0.511904761904762,3.23076923076923
64,"Jakiro",75,"Silencer",58,44,102,0.568627450980392,1.30769230769231
64,"Jakiro",76,"Outworld Devourer",22,26,48,0.458333333333333,0.615384615384615
64,"Jakiro",77,"Lycan",12,18,30,0.4,0.384615384615385
64,"Jakiro",78,"Brewmaster",14,14,28,0.5,0.358974358974359
64,"Jakiro",79,"Shadow Demon",12,10,22,0.545454545454545,0.282051282051282
64,"Jakiro",80,"Lone Druid",15,7,22,0.681818181818182,0.282051282051282
64,"Jakiro",81,"Chaos Knight",16,25,41,0.390243902439024,0.525641025641026
64,"Jakiro",82,"Meepo",14,17,31,0.451612903225806,0.397435897435897
64,"Jakiro",83,"Treant Protector",15,9,24,0.625,0.307692307692308
64,"Jakiro",84,"Ogre Magi",35,34,69,0.507246376811594,0.884615384615385
64,"Jakiro",85,"Undying",72,57,129,0.558139534883721,1.65384615384615
64,"Jakiro",86,"Rubick",45,54,99,0.454545454545455,1.26923076923077
64,"Jakiro",87,"Disruptor",24,39,63,0.380952380952381,0.807692307692308
64,"Jakiro",88,"Nyx Assassin",34,23,57,0.596491228070175,0.730769230769231
64,"Jakiro",89,"Naga Siren",14,9,23,0.608695652173913,0.294871794871795
64,"Jakiro",90,"Keeper of the Light",13,16,29,0.448275862068966,0.371794871794872
64,"Jakiro",91,"Io",9,13,22,0.409090909090909,0.282051282051282
64,"Jakiro",92,"Visage",7,6,13,0.538461538461538,0.166666666666667
64,"Jakiro",93,"Slark",97,103,200,0.485,2.56410256410256
64,"Jakiro",94,"Medusa",19,24,43,0.441860465116279,0.551282051282051
64,"Jakiro",95,"Troll Warlord",24,26,50,0.48,0.641025641025641
64,"Jakiro",96,"Centaur Warrunner",22,22,44,0.5,0.564102564102564
64,"Jakiro",97,"Magnus",39,53,92,0.423913043478261,1.17948717948718
64,"Jakiro",98,"Timbersaw",20,41,61,0.327868852459016,0.782051282051282
64,"Jakiro",99,"Bristleback",53,46,99,0.535353535353535,1.26923076923077
64,"Jakiro",100,"Tusk",100,70,170,0.588235294117647,2.17948717948718
64,"Jakiro",101,"Skywrath Mage",20,26,46,0.434782608695652,0.58974358974359
64,"Jakiro",102,"Abaddon",35,23,58,0.603448275862069,0.743589743589744
64,"Jakiro",103,"Elder Titan",5,6,11,0.454545454545455,0.141025641025641
64,"Jakiro",104,"Legion Commander",90,86,176,0.511363636363636,2.25641025641026
64,"Jakiro",105,"Techies",4,5,9,0.444444444444444,0.115384615384615
64,"Jakiro",106,"Ember Spirit",93,96,189,0.492063492063492,2.42307692307692
64,"Jakiro",107,"Earth Spirit",21,21,42,0.5,0.538461538461538
64,"Jakiro",109,"Terrorblade",21,12,33,0.636363636363636,0.423076923076923
64,"Jakiro",110,"Phoenix",36,26,62,0.580645161290323,0.794871794871795
64,"Jakiro",111,"Oracle",1,13,14,0.0714285714285714,0.179487179487179
64,"Jakiro",112,"Winter Wyvern",45,33,78,0.576923076923077,1
65,"Batrider",66,"Chen",3,1,4,0.75,0.0512820512820513
65,"Batrider",67,"Spectre",27,18,45,0.6,0.576923076923077
65,"Batrider",68,"Ancient Apparition",20,25,45,0.444444444444444,0.576923076923077
65,"Batrider",69,"Doom",18,28,46,0.391304347826087,0.58974358974359
65,"Batrider",70,"Ursa",17,20,37,0.459459459459459,0.474358974358974
65,"Batrider",71,"Spirit Breaker",20,21,41,0.48780487804878,0.525641025641026
65,"Batrider",72,"Gyrocopter",14,27,41,0.341463414634146,0.525641025641026
65,"Batrider",73,"Alchemist",34,38,72,0.472222222222222,0.923076923076923
65,"Batrider",74,"Invoker",40,59,99,0.404040404040404,1.26923076923077
65,"Batrider",75,"Silencer",21,22,43,0.488372093023256,0.551282051282051
65,"Batrider",76,"Outworld Devourer",1,7,8,0.125,0.102564102564103
65,"Batrider",77,"Lycan",4,3,7,0.571428571428571,0.0897435897435897
65,"Batrider",78,"Brewmaster",3,0,3,1,0.0384615384615385
65,"Batrider",79,"Shadow Demon",2,12,14,0.142857142857143,0.179487179487179
65,"Batrider",80,"Lone Druid",6,7,13,0.461538461538462,0.166666666666667
65,"Batrider",81,"Chaos Knight",10,7,17,0.588235294117647,0.217948717948718
65,"Batrider",82,"Meepo",8,5,13,0.615384615384615,0.166666666666667
65,"Batrider",83,"Treant Protector",5,4,9,0.555555555555556,0.115384615384615
65,"Batrider",84,"Ogre Magi",17,15,32,0.53125,0.41025641025641
65,"Batrider",85,"Undying",20,16,36,0.555555555555556,0.461538461538462
65,"Batrider",86,"Rubick",25,51,76,0.328947368421053,0.974358974358974
65,"Batrider",87,"Disruptor",25,16,41,0.609756097560976,0.525641025641026
65,"Batrider",88,"Nyx Assassin",12,10,22,0.545454545454545,0.282051282051282
65,"Batrider",89,"Naga Siren",7,5,12,0.583333333333333,0.153846153846154
65,"Batrider",90,"Keeper of the Light",7,5,12,0.583333333333333,0.153846153846154
65,"Batrider",91,"Io",2,11,13,0.153846153846154,0.166666666666667
65,"Batrider",92,"Visage",5,8,13,0.384615384615385,0.166666666666667
65,"Batrider",93,"Slark",32,38,70,0.457142857142857,0.897435897435897
65,"Batrider",94,"Medusa",18,20,38,0.473684210526316,0.487179487179487
65,"Batrider",95,"Troll Warlord",8,9,17,0.470588235294118,0.217948717948718
65,"Batrider",96,"Centaur Warrunner",6,4,10,0.6,0.128205128205128
65,"Batrider",97,"Magnus",6,8,14,0.428571428571429,0.179487179487179
65,"Batrider",98,"Timbersaw",2,10,12,0.166666666666667,0.153846153846154
65,"Batrider",99,"Bristleback",8,15,23,0.347826086956522,0.294871794871795
65,"Batrider",100,"Tusk",34,37,71,0.47887323943662,0.91025641025641
65,"Batrider",101,"Skywrath Mage",7,15,22,0.318181818181818,0.282051282051282
65,"Batrider",102,"Abaddon",14,15,29,0.482758620689655,0.371794871794872
65,"Batrider",103,"Elder Titan",4,3,7,0.571428571428571,0.0897435897435897
65,"Batrider",104,"Legion Commander",19,42,61,0.311475409836066,0.782051282051282
65,"Batrider",105,"Techies",7,4,11,0.636363636363636,0.141025641025641
65,"Batrider",106,"Ember Spirit",38,35,73,0.520547945205479,0.935897435897436
65,"Batrider",107,"Earth Spirit",10,4,14,0.714285714285714,0.179487179487179
65,"Batrider",109,"Terrorblade",9,5,14,0.642857142857143,0.179487179487179
65,"Batrider",110,"Phoenix",13,11,24,0.541666666666667,0.307692307692308
65,"Batrider",111,"Oracle",0,2,2,0,0.0256410256410256
65,"Batrider",112,"Winter Wyvern",22,35,57,0.385964912280702,0.730769230769231
66,"Chen",67,"Spectre",14,11,25,0.56,0.320512820512821
66,"Chen",68,"Ancient Apparition",7,8,15,0.466666666666667,0.192307692307692
66,"Chen",69,"Doom",15,10,25,0.6,0.320512820512821
66,"Chen",70,"Ursa",12,8,20,0.6,0.256410256410256
66,"Chen",71,"Spirit Breaker",19,12,31,0.612903225806452,0.397435897435897
66,"Chen",72,"Gyrocopter",16,20,36,0.444444444444444,0.461538461538462
66,"Chen",73,"Alchemist",22,22,44,0.5,0.564102564102564
66,"Chen",74,"Invoker",26,26,52,0.5,0.666666666666667
66,"Chen",75,"Silencer",11,9,20,0.55,0.256410256410256
66,"Chen",76,"Outworld Devourer",6,0,6,1,0.0769230769230769
66,"Chen",77,"Lycan",1,3,4,0.25,0.0512820512820513
66,"Chen",78,"Brewmaster",2,4,6,0.333333333333333,0.0769230769230769
66,"Chen",79,"Shadow Demon",1,5,6,0.166666666666667,0.0769230769230769
66,"Chen",80,"Lone Druid",3,4,7,0.428571428571429,0.0897435897435897
66,"Chen",81,"Chaos Knight",8,7,15,0.533333333333333,0.192307692307692
66,"Chen",82,"Meepo",5,2,7,0.714285714285714,0.0897435897435897
66,"Chen",83,"Treant Protector",3,3,6,0.5,0.0769230769230769
66,"Chen",84,"Ogre Magi",7,8,15,0.466666666666667,0.192307692307692
66,"Chen",85,"Undying",11,8,19,0.578947368421053,0.243589743589744
66,"Chen",86,"Rubick",10,18,28,0.357142857142857,0.358974358974359
66,"Chen",87,"Disruptor",9,9,18,0.5,0.230769230769231
66,"Chen",88,"Nyx Assassin",3,5,8,0.375,0.102564102564103
66,"Chen",89,"Naga Siren",4,1,5,0.8,0.0641025641025641
66,"Chen",90,"Keeper of the Light",2,4,6,0.333333333333333,0.0769230769230769
66,"Chen",91,"Io",3,2,5,0.6,0.0641025641025641
66,"Chen",92,"Visage",4,1,5,0.8,0.0641025641025641
66,"Chen",93,"Slark",15,21,36,0.416666666666667,0.461538461538462
66,"Chen",94,"Medusa",3,4,7,0.428571428571429,0.0897435897435897
66,"Chen",95,"Troll Warlord",1,6,7,0.142857142857143,0.0897435897435897
66,"Chen",96,"Centaur Warrunner",4,3,7,0.571428571428571,0.0897435897435897
66,"Chen",97,"Magnus",5,8,13,0.384615384615385,0.166666666666667
66,"Chen",98,"Timbersaw",8,7,15,0.533333333333333,0.192307692307692
66,"Chen",99,"Bristleback",6,8,14,0.428571428571429,0.179487179487179
66,"Chen",100,"Tusk",20,10,30,0.666666666666667,0.384615384615385
66,"Chen",101,"Skywrath Mage",2,9,11,0.181818181818182,0.141025641025641
66,"Chen",102,"Abaddon",9,8,17,0.529411764705882,0.217948717948718
66,"Chen",103,"Elder Titan",1,0,1,1,0.0128205128205128
66,"Chen",104,"Legion Commander",11,17,28,0.392857142857143,0.358974358974359
66,"Chen",105,"Techies",1,0,1,1,0.0128205128205128
66,"Chen",106,"Ember Spirit",14,17,31,0.451612903225806,0.397435897435897
66,"Chen",107,"Earth Spirit",6,5,11,0.545454545454545,0.141025641025641
66,"Chen",109,"Terrorblade",5,8,13,0.384615384615385,0.166666666666667
66,"Chen",110,"Phoenix",11,8,19,0.578947368421053,0.243589743589744
66,"Chen",111,"Oracle",4,0,4,1,0.0512820512820513
66,"Chen",112,"Winter Wyvern",11,12,23,0.478260869565217,0.294871794871795
67,"Spectre",68,"Ancient Apparition",250,173,423,0.591016548463357,5.42307692307692
67,"Spectre",69,"Doom",256,152,408,0.627450980392157,5.23076923076923
67,"Spectre",70,"Ursa",60,44,104,0.576923076923077,1.33333333333333
67,"Spectre",71,"Spirit Breaker",245,157,402,0.609452736318408,5.15384615384615
67,"Spectre",72,"Gyrocopter",63,30,93,0.67741935483871,1.19230769230769
67,"Spectre",73,"Alchemist",196,113,309,0.634304207119741,3.96153846153846
67,"Spectre",74,"Invoker",373,290,663,0.562594268476621,8.5
67,"Spectre",75,"Silencer",271,166,437,0.620137299771167,5.6025641025641
67,"Spectre",76,"Outworld Devourer",38,39,77,0.493506493506494,0.987179487179487
67,"Spectre",77,"Lycan",13,10,23,0.565217391304348,0.294871794871795
67,"Spectre",78,"Brewmaster",18,16,34,0.529411764705882,0.435897435897436
67,"Spectre",79,"Shadow Demon",44,37,81,0.54320987654321,1.03846153846154
67,"Spectre",80,"Lone Druid",21,14,35,0.6,0.448717948717949
67,"Spectre",81,"Chaos Knight",26,16,42,0.619047619047619,0.538461538461538
67,"Spectre",82,"Meepo",38,29,67,0.567164179104478,0.858974358974359
67,"Spectre",83,"Treant Protector",55,41,96,0.572916666666667,1.23076923076923
67,"Spectre",84,"Ogre Magi",145,84,229,0.633187772925764,2.93589743589744
67,"Spectre",85,"Undying",208,132,340,0.611764705882353,4.35897435897436
67,"Spectre",86,"Rubick",251,243,494,0.508097165991903,6.33333333333333
67,"Spectre",87,"Disruptor",159,111,270,0.588888888888889,3.46153846153846
67,"Spectre",88,"Nyx Assassin",90,79,169,0.532544378698225,2.16666666666667
67,"Spectre",89,"Naga Siren",10,14,24,0.416666666666667,0.307692307692308
67,"Spectre",90,"Keeper of the Light",73,46,119,0.613445378151261,1.52564102564103
67,"Spectre",91,"Io",41,32,73,0.561643835616438,0.935897435897436
67,"Spectre",92,"Visage",28,29,57,0.491228070175439,0.730769230769231
67,"Spectre",93,"Slark",69,50,119,0.579831932773109,1.52564102564103
67,"Spectre",94,"Medusa",23,15,38,0.605263157894737,0.487179487179487
67,"Spectre",95,"Troll Warlord",18,12,30,0.6,0.384615384615385
67,"Spectre",96,"Centaur Warrunner",67,37,104,0.644230769230769,1.33333333333333
67,"Spectre",97,"Magnus",84,82,166,0.506024096385542,2.12820512820513
67,"Spectre",98,"Timbersaw",85,68,153,0.555555555555556,1.96153846153846
67,"Spectre",99,"Bristleback",120,96,216,0.555555555555556,2.76923076923077
67,"Spectre",100,"Tusk",369,209,578,0.63840830449827,7.41025641025641
67,"Spectre",101,"Skywrath Mage",86,85,171,0.502923976608187,2.19230769230769
67,"Spectre",102,"Abaddon",90,57,147,0.612244897959184,1.88461538461538
67,"Spectre",103,"Elder Titan",27,21,48,0.5625,0.615384615384615
67,"Spectre",104,"Legion Commander",183,132,315,0.580952380952381,4.03846153846154
67,"Spectre",105,"Techies",37,29,66,0.560606060606061,0.846153846153846
67,"Spectre",106,"Ember Spirit",164,113,277,0.592057761732852,3.55128205128205
67,"Spectre",107,"Earth Spirit",84,76,160,0.525,2.05128205128205
67,"Spectre",109,"Terrorblade",12,12,24,0.5,0.307692307692308
67,"Spectre",110,"Phoenix",109,65,174,0.626436781609195,2.23076923076923
67,"Spectre",111,"Oracle",36,23,59,0.610169491525424,0.756410256410256
67,"Spectre",112,"Winter Wyvern",306,190,496,0.616935483870968,6.35897435897436
68,"Ancient Apparition",69,"Doom",218,205,423,0.515366430260047,5.42307692307692
68,"Ancient Apparition",70,"Ursa",100,91,191,0.523560209424084,2.44871794871795
68,"Ancient Apparition",71,"Spirit Breaker",202,158,360,0.561111111111111,4.61538461538461
68,"Ancient Apparition",72,"Gyrocopter",183,215,398,0.459798994974874,5.1025641025641
68,"Ancient Apparition",73,"Alchemist",299,264,563,0.531083481349911,7.21794871794872
68,"Ancient Apparition",74,"Invoker",308,316,624,0.493589743589744,8
68,"Ancient Apparition",75,"Silencer",129,112,241,0.535269709543568,3.08974358974359
68,"Ancient Apparition",76,"Outworld Devourer",33,48,81,0.407407407407407,1.03846153846154
68,"Ancient Apparition",77,"Lycan",21,27,48,0.4375,0.615384615384615
68,"Ancient Apparition",78,"Brewmaster",26,27,53,0.490566037735849,0.67948717948718
68,"Ancient Apparition",79,"Shadow Demon",8,22,30,0.266666666666667,0.384615384615385
68,"Ancient Apparition",80,"Lone Druid",20,25,45,0.444444444444444,0.576923076923077
68,"Ancient Apparition",81,"Chaos Knight",82,70,152,0.539473684210526,1.94871794871795
68,"Ancient Apparition",82,"Meepo",33,35,68,0.485294117647059,0.871794871794872
68,"Ancient Apparition",83,"Treant Protector",31,31,62,0.5,0.794871794871795
68,"Ancient Apparition",84,"Ogre Magi",71,85,156,0.455128205128205,2
68,"Ancient Apparition",85,"Undying",143,106,249,0.57429718875502,3.19230769230769
68,"Ancient Apparition",86,"Rubick",105,142,247,0.425101214574899,3.16666666666667
68,"Ancient Apparition",87,"Disruptor",51,52,103,0.495145631067961,1.32051282051282
68,"Ancient Apparition",88,"Nyx Assassin",63,70,133,0.473684210526316,1.70512820512821
68,"Ancient Apparition",89,"Naga Siren",23,21,44,0.522727272727273,0.564102564102564
68,"Ancient Apparition",90,"Keeper of the Light",18,36,54,0.333333333333333,0.692307692307692
68,"Ancient Apparition",91,"Io",27,32,59,0.457627118644068,0.756410256410256
68,"Ancient Apparition",92,"Visage",6,22,28,0.214285714285714,0.358974358974359
68,"Ancient Apparition",93,"Slark",254,257,511,0.49706457925636,6.55128205128205
68,"Ancient Apparition",94,"Medusa",54,62,116,0.46551724137931,1.48717948717949
68,"Ancient Apparition",95,"Troll Warlord",40,55,95,0.421052631578947,1.21794871794872
68,"Ancient Apparition",96,"Centaur Warrunner",62,51,113,0.548672566371681,1.44871794871795
68,"Ancient Apparition",97,"Magnus",95,129,224,0.424107142857143,2.87179487179487
68,"Ancient Apparition",98,"Timbersaw",75,88,163,0.460122699386503,2.08974358974359
68,"Ancient Apparition",99,"Bristleback",111,97,208,0.533653846153846,2.66666666666667
68,"Ancient Apparition",100,"Tusk",259,281,540,0.47962962962963,6.92307692307692
68,"Ancient Apparition",101,"Skywrath Mage",29,50,79,0.367088607594937,1.01282051282051
68,"Ancient Apparition",102,"Abaddon",76,55,131,0.580152671755725,1.67948717948718
68,"Ancient Apparition",103,"Elder Titan",15,24,39,0.384615384615385,0.5
68,"Ancient Apparition",104,"Legion Commander",209,241,450,0.464444444444444,5.76923076923077
68,"Ancient Apparition",105,"Techies",14,26,40,0.35,0.512820512820513
68,"Ancient Apparition",106,"Ember Spirit",201,238,439,0.457858769931663,5.62820512820513
68,"Ancient Apparition",107,"Earth Spirit",62,64,126,0.492063492063492,1.61538461538462
68,"Ancient Apparition",109,"Terrorblade",42,34,76,0.552631578947368,0.974358974358974
68,"Ancient Apparition",110,"Phoenix",70,76,146,0.479452054794521,1.87179487179487
68,"Ancient Apparition",111,"Oracle",17,13,30,0.566666666666667,0.384615384615385
68,"Ancient Apparition",112,"Winter Wyvern",101,99,200,0.505,2.56410256410256
69,"Doom",70,"Ursa",114,81,195,0.584615384615385,2.5
69,"Doom",71,"Spirit Breaker",201,145,346,0.580924855491329,4.43589743589744
69,"Doom",72,"Gyrocopter",231,209,440,0.525,5.64102564102564
69,"Doom",73,"Alchemist",334,235,569,0.586994727592267,7.29487179487179
69,"Doom",74,"Invoker",407,310,717,0.567642956764296,9.19230769230769
69,"Doom",75,"Silencer",250,193,443,0.564334085778781,5.67948717948718
69,"Doom",76,"Outworld Devourer",51,29,80,0.6375,1.02564102564103
69,"Doom",77,"Lycan",21,19,40,0.525,0.512820512820513
69,"Doom",78,"Brewmaster",18,14,32,0.5625,0.41025641025641
69,"Doom",79,"Shadow Demon",34,55,89,0.382022471910112,1.14102564102564
69,"Doom",80,"Lone Druid",24,20,44,0.545454545454545,0.564102564102564
69,"Doom",81,"Chaos Knight",56,49,105,0.533333333333333,1.34615384615385
69,"Doom",82,"Meepo",59,40,99,0.595959595959596,1.26923076923077
69,"Doom",83,"Treant Protector",54,43,97,0.556701030927835,1.24358974358974
69,"Doom",84,"Ogre Magi",130,77,207,0.628019323671498,2.65384615384615
69,"Doom",85,"Undying",137,115,252,0.543650793650794,3.23076923076923
69,"Doom",86,"Rubick",276,304,580,0.475862068965517,7.43589743589744
69,"Doom",87,"Disruptor",162,137,299,0.54180602006689,3.83333333333333
69,"Doom",88,"Nyx Assassin",59,56,115,0.51304347826087,1.47435897435897
69,"Doom",89,"Naga Siren",19,21,40,0.475,0.512820512820513
69,"Doom",90,"Keeper of the Light",66,55,121,0.545454545454545,1.55128205128205
69,"Doom",91,"Io",51,50,101,0.504950495049505,1.29487179487179
69,"Doom",92,"Visage",30,27,57,0.526315789473684,0.730769230769231
69,"Doom",93,"Slark",269,243,512,0.525390625,6.56410256410256
69,"Doom",94,"Medusa",65,61,126,0.515873015873016,1.61538461538462
69,"Doom",95,"Troll Warlord",39,39,78,0.5,1
69,"Doom",96,"Centaur Warrunner",17,24,41,0.414634146341463,0.525641025641026
69,"Doom",97,"Magnus",67,73,140,0.478571428571429,1.79487179487179
69,"Doom",98,"Timbersaw",36,54,90,0.4,1.15384615384615
69,"Doom",99,"Bristleback",64,60,124,0.516129032258065,1.58974358974359
69,"Doom",100,"Tusk",298,235,533,0.559099437148218,6.83333333333333
69,"Doom",101,"Skywrath Mage",91,110,201,0.45273631840796,2.57692307692308
69,"Doom",102,"Abaddon",90,61,151,0.596026490066225,1.93589743589744
69,"Doom",103,"Elder Titan",20,25,45,0.444444444444444,0.576923076923077
69,"Doom",104,"Legion Commander",172,144,316,0.544303797468354,4.05128205128205
69,"Doom",105,"Techies",31,24,55,0.563636363636364,0.705128205128205
69,"Doom",106,"Ember Spirit",276,268,544,0.507352941176471,6.97435897435897
69,"Doom",107,"Earth Spirit",104,80,184,0.565217391304348,2.35897435897436
69,"Doom",109,"Terrorblade",51,33,84,0.607142857142857,1.07692307692308
69,"Doom",110,"Phoenix",70,50,120,0.583333333333333,1.53846153846154
69,"Doom",111,"Oracle",26,27,53,0.490566037735849,0.67948717948718
69,"Doom",112,"Winter Wyvern",331,245,576,0.574652777777778,7.38461538461539
70,"Ursa",71,"Spirit Breaker",120,68,188,0.638297872340426,2.41025641025641
70,"Ursa",72,"Gyrocopter",75,57,132,0.568181818181818,1.69230769230769
70,"Ursa",73,"Alchemist",155,117,272,0.569852941176471,3.48717948717949
70,"Ursa",74,"Invoker",215,192,407,0.528255528255528,5.21794871794872
70,"Ursa",75,"Silencer",131,87,218,0.600917431192661,2.79487179487179
70,"Ursa",76,"Outworld Devourer",35,24,59,0.593220338983051,0.756410256410256
70,"Ursa",77,"Lycan",9,7,16,0.5625,0.205128205128205
70,"Ursa",78,"Brewmaster",24,14,38,0.631578947368421,0.487179487179487
70,"Ursa",79,"Shadow Demon",20,20,40,0.5,0.512820512820513
70,"Ursa",80,"Lone Druid",14,15,29,0.482758620689655,0.371794871794872
70,"Ursa",81,"Chaos Knight",30,14,44,0.681818181818182,0.564102564102564
70,"Ursa",82,"Meepo",13,20,33,0.393939393939394,0.423076923076923
70,"Ursa",83,"Treant Protector",35,13,48,0.729166666666667,0.615384615384615
70,"Ursa",84,"Ogre Magi",94,55,149,0.630872483221476,1.91025641025641
70,"Ursa",85,"Undying",107,62,169,0.633136094674556,2.16666666666667
70,"Ursa",86,"Rubick",133,101,234,0.568376068376068,3
70,"Ursa",87,"Disruptor",83,42,125,0.664,1.6025641025641
70,"Ursa",88,"Nyx Assassin",31,34,65,0.476923076923077,0.833333333333333
70,"Ursa",89,"Naga Siren",20,9,29,0.689655172413793,0.371794871794872
70,"Ursa",90,"Keeper of the Light",52,28,80,0.65,1.02564102564103
70,"Ursa",91,"Io",44,42,86,0.511627906976744,1.1025641025641
70,"Ursa",92,"Visage",16,11,27,0.592592592592593,0.346153846153846
70,"Ursa",93,"Slark",120,89,209,0.574162679425837,2.67948717948718
70,"Ursa",94,"Medusa",42,21,63,0.666666666666667,0.807692307692308
70,"Ursa",95,"Troll Warlord",23,15,38,0.605263157894737,0.487179487179487
70,"Ursa",96,"Centaur Warrunner",34,22,56,0.607142857142857,0.717948717948718
70,"Ursa",97,"Magnus",51,45,96,0.53125,1.23076923076923
70,"Ursa",98,"Timbersaw",55,53,108,0.509259259259259,1.38461538461538
70,"Ursa",99,"Bristleback",52,45,97,0.536082474226804,1.24358974358974
70,"Ursa",100,"Tusk",160,136,296,0.540540540540541,3.79487179487179
70,"Ursa",101,"Skywrath Mage",34,53,87,0.390804597701149,1.11538461538462
70,"Ursa",102,"Abaddon",61,35,96,0.635416666666667,1.23076923076923
70,"Ursa",103,"Elder Titan",14,8,22,0.636363636363636,0.282051282051282
70,"Ursa",104,"Legion Commander",131,106,237,0.552742616033755,3.03846153846154
70,"Ursa",105,"Techies",20,12,32,0.625,0.41025641025641
70,"Ursa",106,"Ember Spirit",112,102,214,0.523364485981308,2.74358974358974
70,"Ursa",107,"Earth Spirit",51,40,91,0.56043956043956,1.16666666666667
70,"Ursa",109,"Terrorblade",20,16,36,0.555555555555556,0.461538461538462
70,"Ursa",110,"Phoenix",52,37,89,0.584269662921348,1.14102564102564
70,"Ursa",111,"Oracle",27,14,41,0.658536585365854,0.525641025641026
70,"Ursa",112,"Winter Wyvern",139,87,226,0.615044247787611,2.8974358974359
71,"Spirit Breaker",72,"Gyrocopter",228,173,401,0.56857855361596,5.14102564102564
71,"Spirit Breaker",73,"Alchemist",316,210,526,0.600760456273764,6.74358974358974
71,"Spirit Breaker",74,"Invoker",370,319,689,0.537010159651669,8.83333333333333
71,"Spirit Breaker",75,"Silencer",238,171,409,0.581907090464548,5.24358974358974
71,"Spirit Breaker",76,"Outworld Devourer",40,36,76,0.526315789473684,0.974358974358974
71,"Spirit Breaker",77,"Lycan",41,25,66,0.621212121212121,0.846153846153846
71,"Spirit Breaker",78,"Brewmaster",16,21,37,0.432432432432432,0.474358974358974
71,"Spirit Breaker",79,"Shadow Demon",21,37,58,0.362068965517241,0.743589743589744
71,"Spirit Breaker",80,"Lone Druid",10,27,37,0.27027027027027,0.474358974358974
71,"Spirit Breaker",81,"Chaos Knight",41,59,100,0.41,1.28205128205128
71,"Spirit Breaker",82,"Meepo",39,42,81,0.481481481481481,1.03846153846154
71,"Spirit Breaker",83,"Treant Protector",31,34,65,0.476923076923077,0.833333333333333
71,"Spirit Breaker",84,"Ogre Magi",101,74,175,0.577142857142857,2.24358974358974
71,"Spirit Breaker",85,"Undying",180,104,284,0.633802816901408,3.64102564102564
71,"Spirit Breaker",86,"Rubick",208,227,435,0.47816091954023,5.57692307692308
71,"Spirit Breaker",87,"Disruptor",136,116,252,0.53968253968254,3.23076923076923
71,"Spirit Breaker",88,"Nyx Assassin",54,61,115,0.469565217391304,1.47435897435897
71,"Spirit Breaker",89,"Naga Siren",14,17,31,0.451612903225806,0.397435897435897
71,"Spirit Breaker",90,"Keeper of the Light",45,57,102,0.441176470588235,1.30769230769231
71,"Spirit Breaker",91,"Io",45,46,91,0.494505494505495,1.16666666666667
71,"Spirit Breaker",92,"Visage",31,21,52,0.596153846153846,0.666666666666667
71,"Spirit Breaker",93,"Slark",240,223,463,0.518358531317495,5.93589743589744
71,"Spirit Breaker",94,"Medusa",73,49,122,0.598360655737705,1.56410256410256
71,"Spirit Breaker",95,"Troll Warlord",55,49,104,0.528846153846154,1.33333333333333
71,"Spirit Breaker",96,"Centaur Warrunner",33,27,60,0.55,0.769230769230769
71,"Spirit Breaker",97,"Magnus",51,71,122,0.418032786885246,1.56410256410256
71,"Spirit Breaker",98,"Timbersaw",60,59,119,0.504201680672269,1.52564102564103
71,"Spirit Breaker",99,"Bristleback",68,72,140,0.485714285714286,1.79487179487179
71,"Spirit Breaker",100,"Tusk",211,177,388,0.543814432989691,4.97435897435897
71,"Spirit Breaker",101,"Skywrath Mage",73,80,153,0.477124183006536,1.96153846153846
71,"Spirit Breaker",102,"Abaddon",88,55,143,0.615384615384615,1.83333333333333
71,"Spirit Breaker",103,"Elder Titan",20,18,38,0.526315789473684,0.487179487179487
71,"Spirit Breaker",104,"Legion Commander",206,175,381,0.540682414698163,4.88461538461539
71,"Spirit Breaker",105,"Techies",21,30,51,0.411764705882353,0.653846153846154
71,"Spirit Breaker",106,"Ember Spirit",243,195,438,0.554794520547945,5.61538461538461
71,"Spirit Breaker",107,"Earth Spirit",74,44,118,0.627118644067797,1.51282051282051
71,"Spirit Breaker",109,"Terrorblade",46,30,76,0.605263157894737,0.974358974358974
71,"Spirit Breaker",110,"Phoenix",79,65,144,0.548611111111111,1.84615384615385
71,"Spirit Breaker",111,"Oracle",16,29,45,0.355555555555556,0.576923076923077
71,"Spirit Breaker",112,"Winter Wyvern",230,183,413,0.556900726392252,5.29487179487179
72,"Gyrocopter",73,"Alchemist",292,242,534,0.546816479400749,6.84615384615385
72,"Gyrocopter",74,"Invoker",295,296,591,0.499153976311337,7.57692307692308
72,"Gyrocopter",75,"Silencer",202,162,364,0.554945054945055,4.66666666666667
72,"Gyrocopter",76,"Outworld Devourer",29,37,66,0.439393939393939,0.846153846153846
72,"Gyrocopter",77,"Lycan",16,19,35,0.457142857142857,0.448717948717949
72,"Gyrocopter",78,"Brewmaster",26,21,47,0.553191489361702,0.602564102564103
72,"Gyrocopter",79,"Shadow Demon",29,56,85,0.341176470588235,1.08974358974359
72,"Gyrocopter",80,"Lone Druid",16,17,33,0.484848484848485,0.423076923076923
72,"Gyrocopter",81,"Chaos Knight",21,25,46,0.456521739130435,0.58974358974359
72,"Gyrocopter",82,"Meepo",34,27,61,0.557377049180328,0.782051282051282
72,"Gyrocopter",83,"Treant Protector",58,48,106,0.547169811320755,1.35897435897436
72,"Gyrocopter",84,"Ogre Magi",141,126,267,0.528089887640449,3.42307692307692
72,"Gyrocopter",85,"Undying",210,173,383,0.548302872062663,4.91025641025641
72,"Gyrocopter",86,"Rubick",223,283,506,0.440711462450593,6.48717948717949
72,"Gyrocopter",87,"Disruptor",153,150,303,0.504950495049505,3.88461538461538
72,"Gyrocopter",88,"Nyx Assassin",81,83,164,0.49390243902439,2.1025641025641
72,"Gyrocopter",89,"Naga Siren",25,27,52,0.480769230769231,0.666666666666667
72,"Gyrocopter",90,"Keeper of the Light",47,58,105,0.447619047619048,1.34615384615385
72,"Gyrocopter",91,"Io",37,49,86,0.430232558139535,1.1025641025641
72,"Gyrocopter",92,"Visage",27,22,49,0.551020408163265,0.628205128205128
72,"Gyrocopter",93,"Slark",78,95,173,0.450867052023121,2.21794871794872
72,"Gyrocopter",94,"Medusa",26,20,46,0.565217391304348,0.58974358974359
72,"Gyrocopter",95,"Troll Warlord",18,20,38,0.473684210526316,0.487179487179487
72,"Gyrocopter",96,"Centaur Warrunner",50,42,92,0.543478260869565,1.17948717948718
72,"Gyrocopter",97,"Magnus",86,114,200,0.43,2.56410256410256
72,"Gyrocopter",98,"Timbersaw",62,84,146,0.424657534246575,1.87179487179487
72,"Gyrocopter",99,"Bristleback",100,109,209,0.478468899521531,2.67948717948718
72,"Gyrocopter",100,"Tusk",339,316,655,0.517557251908397,8.3974358974359
72,"Gyrocopter",101,"Skywrath Mage",70,83,153,0.457516339869281,1.96153846153846
72,"Gyrocopter",102,"Abaddon",103,82,185,0.556756756756757,2.37179487179487
72,"Gyrocopter",103,"Elder Titan",29,21,50,0.58,0.641025641025641
72,"Gyrocopter",104,"Legion Commander",199,198,397,0.501259445843829,5.08974358974359
72,"Gyrocopter",105,"Techies",22,35,57,0.385964912280702,0.730769230769231
72,"Gyrocopter",106,"Ember Spirit",145,146,291,0.498281786941581,3.73076923076923
72,"Gyrocopter",107,"Earth Spirit",91,81,172,0.529069767441861,2.20512820512821
72,"Gyrocopter",109,"Terrorblade",15,19,34,0.441176470588235,0.435897435897436
72,"Gyrocopter",110,"Phoenix",78,97,175,0.445714285714286,2.24358974358974
72,"Gyrocopter",111,"Oracle",21,25,46,0.456521739130435,0.58974358974359
72,"Gyrocopter",112,"Winter Wyvern",276,264,540,0.511111111111111,6.92307692307692
73,"Alchemist",74,"Invoker",272,301,573,0.474694589877836,7.34615384615385
73,"Alchemist",75,"Silencer",312,237,549,0.568306010928962,7.03846153846154
73,"Alchemist",76,"Outworld Devourer",25,35,60,0.416666666666667,0.769230769230769
73,"Alchemist",77,"Lycan",31,27,58,0.53448275862069,0.743589743589744
73,"Alchemist",78,"Brewmaster",28,31,59,0.474576271186441,0.756410256410256
73,"Alchemist",79,"Shadow Demon",49,73,122,0.401639344262295,1.56410256410256
73,"Alchemist",80,"Lone Druid",27,39,66,0.409090909090909,0.846153846153846
73,"Alchemist",81,"Chaos Knight",67,65,132,0.507575757575758,1.69230769230769
73,"Alchemist",82,"Meepo",45,54,99,0.454545454545455,1.26923076923077
73,"Alchemist",83,"Treant Protector",80,79,159,0.50314465408805,2.03846153846154
73,"Alchemist",84,"Ogre Magi",178,174,352,0.505681818181818,4.51282051282051
73,"Alchemist",85,"Undying",268,181,449,0.596881959910913,5.75641025641026
73,"Alchemist",86,"Rubick",344,356,700,0.491428571428571,8.97435897435897
73,"Alchemist",87,"Disruptor",197,138,335,0.588059701492537,4.29487179487179
73,"Alchemist",88,"Nyx Assassin",134,87,221,0.606334841628959,2.83333333333333
73,"Alchemist",89,"Naga Siren",21,24,45,0.466666666666667,0.576923076923077
73,"Alchemist",90,"Keeper of the Light",95,102,197,0.482233502538071,2.52564102564103
73,"Alchemist",91,"Io",48,60,108,0.444444444444444,1.38461538461538
73,"Alchemist",92,"Visage",48,33,81,0.592592592592593,1.03846153846154
73,"Alchemist",93,"Slark",268,265,533,0.50281425891182,6.83333333333333
73,"Alchemist",94,"Medusa",69,55,124,0.556451612903226,1.58974358974359
73,"Alchemist",95,"Troll Warlord",50,64,114,0.43859649122807,1.46153846153846
73,"Alchemist",96,"Centaur Warrunner",70,61,131,0.534351145038168,1.67948717948718
73,"Alchemist",97,"Magnus",91,101,192,0.473958333333333,2.46153846153846
73,"Alchemist",98,"Timbersaw",98,123,221,0.443438914027149,2.83333333333333
73,"Alchemist",99,"Bristleback",142,151,293,0.484641638225256,3.75641025641026
73,"Alchemist",100,"Tusk",439,361,800,0.54875,10.2564102564103
73,"Alchemist",101,"Skywrath Mage",101,108,209,0.483253588516746,2.67948717948718
73,"Alchemist",102,"Abaddon",135,107,242,0.557851239669422,3.1025641025641
73,"Alchemist",103,"Elder Titan",29,32,61,0.475409836065574,0.782051282051282
73,"Alchemist",104,"Legion Commander",292,338,630,0.463492063492064,8.07692307692308
73,"Alchemist",105,"Techies",43,46,89,0.48314606741573,1.14102564102564
73,"Alchemist",106,"Ember Spirit",167,185,352,0.474431818181818,4.51282051282051
73,"Alchemist",107,"Earth Spirit",121,97,218,0.555045871559633,2.79487179487179
73,"Alchemist",109,"Terrorblade",46,35,81,0.567901234567901,1.03846153846154
73,"Alchemist",110,"Phoenix",133,105,238,0.558823529411765,3.05128205128205
73,"Alchemist",111,"Oracle",52,48,100,0.52,1.28205128205128
73,"Alchemist",112,"Winter Wyvern",326,279,605,0.538842975206612,7.75641025641026
74,"Invoker",75,"Silencer",309,284,593,0.521079258010118,7.6025641025641
74,"Invoker",76,"Outworld Devourer",18,34,52,0.346153846153846,0.666666666666667
74,"Invoker",77,"Lycan",34,39,73,0.465753424657534,0.935897435897436
74,"Invoker",78,"Brewmaster",37,34,71,0.52112676056338,0.91025641025641
74,"Invoker",79,"Shadow Demon",53,80,133,0.398496240601504,1.70512820512821
74,"Invoker",80,"Lone Druid",39,43,82,0.475609756097561,1.05128205128205
74,"Invoker",81,"Chaos Knight",109,103,212,0.514150943396226,2.71794871794872
74,"Invoker",82,"Meepo",51,64,115,0.443478260869565,1.47435897435897
74,"Invoker",83,"Treant Protector",84,79,163,0.515337423312883,2.08974358974359
74,"Invoker",84,"Ogre Magi",214,184,398,0.537688442211055,5.1025641025641
74,"Invoker",85,"Undying",312,244,556,0.561151079136691,7.12820512820513
74,"Invoker",86,"Rubick",334,441,775,0.430967741935484,9.93589743589744
74,"Invoker",87,"Disruptor",237,202,439,0.539863325740319,5.62820512820513
74,"Invoker",88,"Nyx Assassin",104,129,233,0.446351931330472,2.98717948717949
74,"Invoker",89,"Naga Siren",38,40,78,0.487179487179487,1
74,"Invoker",90,"Keeper of the Light",84,99,183,0.459016393442623,2.34615384615385
74,"Invoker",91,"Io",60,73,133,0.451127819548872,1.70512820512821
74,"Invoker",92,"Visage",46,48,94,0.48936170212766,1.20512820512821
74,"Invoker",93,"Slark",401,401,802,0.5,10.2820512820513
74,"Invoker",94,"Medusa",107,85,192,0.557291666666667,2.46153846153846
74,"Invoker",95,"Troll Warlord",90,91,181,0.497237569060773,2.32051282051282
74,"Invoker",96,"Centaur Warrunner",78,72,150,0.52,1.92307692307692
74,"Invoker",97,"Magnus",103,147,250,0.412,3.20512820512821
74,"Invoker",98,"Timbersaw",85,122,207,0.410628019323671,2.65384615384615
74,"Invoker",99,"Bristleback",153,193,346,0.442196531791907,4.43589743589744
74,"Invoker",100,"Tusk",476,436,912,0.521929824561403,11.6923076923077
74,"Invoker",101,"Skywrath Mage",112,135,247,0.453441295546559,3.16666666666667
74,"Invoker",102,"Abaddon",163,151,314,0.519108280254777,4.02564102564103
74,"Invoker",103,"Elder Titan",30,35,65,0.461538461538462,0.833333333333333
74,"Invoker",104,"Legion Commander",419,500,919,0.455930359085963,11.7820512820513
74,"Invoker",105,"Techies",47,57,104,0.451923076923077,1.33333333333333
74,"Invoker",106,"Ember Spirit",206,257,463,0.444924406047516,5.93589743589744
74,"Invoker",107,"Earth Spirit",127,107,234,0.542735042735043,3
74,"Invoker",109,"Terrorblade",67,59,126,0.531746031746032,1.61538461538462
74,"Invoker",110,"Phoenix",132,132,264,0.5,3.38461538461538
74,"Invoker",111,"Oracle",37,40,77,0.480519480519481,0.987179487179487
74,"Invoker",112,"Winter Wyvern",348,326,674,0.516320474777448,8.64102564102564
75,"Silencer",76,"Outworld Devourer",35,37,72,0.486111111111111,0.923076923076923
75,"Silencer",77,"Lycan",24,38,62,0.387096774193548,0.794871794871795
75,"Silencer",78,"Brewmaster",33,19,52,0.634615384615385,0.666666666666667
75,"Silencer",79,"Shadow Demon",19,34,53,0.358490566037736,0.67948717948718
75,"Silencer",80,"Lone Druid",22,22,44,0.5,0.564102564102564
75,"Silencer",81,"Chaos Knight",73,58,131,0.557251908396947,1.67948717948718
75,"Silencer",82,"Meepo",52,39,91,0.571428571428571,1.16666666666667
75,"Silencer",83,"Treant Protector",36,31,67,0.537313432835821,0.858974358974359
75,"Silencer",84,"Ogre Magi",128,103,231,0.554112554112554,2.96153846153846
75,"Silencer",85,"Undying",177,100,277,0.63898916967509,3.55128205128205
75,"Silencer",86,"Rubick",147,187,334,0.440119760479042,4.28205128205128
75,"Silencer",87,"Disruptor",82,78,160,0.5125,2.05128205128205
75,"Silencer",88,"Nyx Assassin",67,74,141,0.475177304964539,1.80769230769231
75,"Silencer",89,"Naga Siren",21,22,43,0.488372093023256,0.551282051282051
75,"Silencer",90,"Keeper of the Light",33,48,81,0.407407407407407,1.03846153846154
75,"Silencer",91,"Io",30,33,63,0.476190476190476,0.807692307692308
75,"Silencer",92,"Visage",17,19,36,0.472222222222222,0.461538461538462
75,"Silencer",93,"Slark",275,250,525,0.523809523809524,6.73076923076923
75,"Silencer",94,"Medusa",63,67,130,0.484615384615385,1.66666666666667
75,"Silencer",95,"Troll Warlord",61,48,109,0.559633027522936,1.3974358974359
75,"Silencer",96,"Centaur Warrunner",82,55,137,0.598540145985402,1.75641025641026
75,"Silencer",97,"Magnus",87,98,185,0.47027027027027,2.37179487179487
75,"Silencer",98,"Timbersaw",81,71,152,0.532894736842105,1.94871794871795
75,"Silencer",99,"Bristleback",104,115,219,0.474885844748858,2.80769230769231
75,"Silencer",100,"Tusk",301,254,555,0.542342342342342,7.11538461538461
75,"Silencer",101,"Skywrath Mage",53,65,118,0.449152542372881,1.51282051282051
75,"Silencer",102,"Abaddon",100,61,161,0.62111801242236,2.06410256410256
75,"Silencer",103,"Elder Titan",16,14,30,0.533333333333333,0.384615384615385
75,"Silencer",104,"Legion Commander",274,266,540,0.507407407407407,6.92307692307692
75,"Silencer",105,"Techies",29,16,45,0.644444444444444,0.576923076923077
75,"Silencer",106,"Ember Spirit",203,190,393,0.516539440203562,5.03846153846154
75,"Silencer",107,"Earth Spirit",94,66,160,0.5875,2.05128205128205
75,"Silencer",109,"Terrorblade",36,39,75,0.48,0.961538461538462
75,"Silencer",110,"Phoenix",70,55,125,0.56,1.6025641025641
75,"Silencer",111,"Oracle",17,18,35,0.485714285714286,0.448717948717949
75,"Silencer",112,"Winter Wyvern",140,129,269,0.520446096654275,3.44871794871795
76,"Outworld Devourer",77,"Lycan",11,7,18,0.611111111111111,0.230769230769231
76,"Outworld Devourer",78,"Brewmaster",6,3,9,0.666666666666667,0.115384615384615
76,"Outworld Devourer",79,"Shadow Demon",9,13,22,0.409090909090909,0.282051282051282
76,"Outworld Devourer",80,"Lone Druid",4,4,8,0.5,0.102564102564103
76,"Outworld Devourer",81,"Chaos Knight",9,13,22,0.409090909090909,0.282051282051282
76,"Outworld Devourer",82,"Meepo",8,7,15,0.533333333333333,0.192307692307692
76,"Outworld Devourer",83,"Treant Protector",14,13,27,0.518518518518518,0.346153846153846
76,"Outworld Devourer",84,"Ogre Magi",33,28,61,0.540983606557377,0.782051282051282
76,"Outworld Devourer",85,"Undying",32,41,73,0.438356164383562,0.935897435897436
76,"Outworld Devourer",86,"Rubick",39,55,94,0.414893617021277,1.20512820512821
76,"Outworld Devourer",87,"Disruptor",23,25,48,0.479166666666667,0.615384615384615
76,"Outworld Devourer",88,"Nyx Assassin",12,18,30,0.4,0.384615384615385
76,"Outworld Devourer",89,"Naga Siren",10,12,22,0.454545454545455,0.282051282051282
76,"Outworld Devourer",90,"Keeper of the Light",13,15,28,0.464285714285714,0.358974358974359
76,"Outworld Devourer",91,"Io",4,9,13,0.307692307692308,0.166666666666667
76,"Outworld Devourer",92,"Visage",4,8,12,0.333333333333333,0.153846153846154
76,"Outworld Devourer",93,"Slark",36,51,87,0.413793103448276,1.11538461538462
76,"Outworld Devourer",94,"Medusa",12,16,28,0.428571428571429,0.358974358974359
76,"Outworld Devourer",95,"Troll Warlord",11,13,24,0.458333333333333,0.307692307692308
76,"Outworld Devourer",96,"Centaur Warrunner",11,10,21,0.523809523809524,0.269230769230769
76,"Outworld Devourer",97,"Magnus",9,23,32,0.28125,0.41025641025641
76,"Outworld Devourer",98,"Timbersaw",9,19,28,0.321428571428571,0.358974358974359
76,"Outworld Devourer",99,"Bristleback",23,29,52,0.442307692307692,0.666666666666667
76,"Outworld Devourer",100,"Tusk",56,47,103,0.543689320388349,1.32051282051282
76,"Outworld Devourer",101,"Skywrath Mage",11,21,32,0.34375,0.41025641025641
76,"Outworld Devourer",102,"Abaddon",23,16,39,0.58974358974359,0.5
76,"Outworld Devourer",103,"Elder Titan",3,5,8,0.375,0.102564102564103
76,"Outworld Devourer",104,"Legion Commander",56,66,122,0.459016393442623,1.56410256410256
76,"Outworld Devourer",105,"Techies",5,6,11,0.454545454545455,0.141025641025641
76,"Outworld Devourer",106,"Ember Spirit",24,31,55,0.436363636363636,0.705128205128205
76,"Outworld Devourer",107,"Earth Spirit",13,13,26,0.5,0.333333333333333
76,"Outworld Devourer",109,"Terrorblade",9,8,17,0.529411764705882,0.217948717948718
76,"Outworld Devourer",110,"Phoenix",14,17,31,0.451612903225806,0.397435897435897
76,"Outworld Devourer",111,"Oracle",7,7,14,0.5,0.179487179487179
76,"Outworld Devourer",112,"Winter Wyvern",39,50,89,0.438202247191011,1.14102564102564
77,"Lycan",78,"Brewmaster",4,2,6,0.666666666666667,0.0769230769230769
77,"Lycan",79,"Shadow Demon",3,7,10,0.3,0.128205128205128
77,"Lycan",80,"Lone Druid",7,4,11,0.636363636363636,0.141025641025641
77,"Lycan",81,"Chaos Knight",7,9,16,0.4375,0.205128205128205
77,"Lycan",82,"Meepo",5,7,12,0.416666666666667,0.153846153846154
77,"Lycan",83,"Treant Protector",5,3,8,0.625,0.102564102564103
77,"Lycan",84,"Ogre Magi",20,16,36,0.555555555555556,0.461538461538462
77,"Lycan",85,"Undying",18,20,38,0.473684210526316,0.487179487179487
77,"Lycan",86,"Rubick",16,34,50,0.32,0.641025641025641
77,"Lycan",87,"Disruptor",11,9,20,0.55,0.256410256410256
77,"Lycan",88,"Nyx Assassin",9,8,17,0.529411764705882,0.217948717948718
77,"Lycan",89,"Naga Siren",3,3,6,0.5,0.0769230769230769
77,"Lycan",90,"Keeper of the Light",8,7,15,0.533333333333333,0.192307692307692
77,"Lycan",91,"Io",3,4,7,0.428571428571429,0.0897435897435897
77,"Lycan",92,"Visage",6,4,10,0.6,0.128205128205128
77,"Lycan",93,"Slark",18,26,44,0.409090909090909,0.564102564102564
77,"Lycan",94,"Medusa",5,5,10,0.5,0.128205128205128
77,"Lycan",95,"Troll Warlord",3,6,9,0.333333333333333,0.115384615384615
77,"Lycan",96,"Centaur Warrunner",10,2,12,0.833333333333333,0.153846153846154
77,"Lycan",97,"Magnus",18,15,33,0.545454545454545,0.423076923076923
77,"Lycan",98,"Timbersaw",12,10,22,0.545454545454545,0.282051282051282
77,"Lycan",99,"Bristleback",9,13,22,0.409090909090909,0.282051282051282
77,"Lycan",100,"Tusk",29,28,57,0.508771929824561,0.730769230769231
77,"Lycan",101,"Skywrath Mage",13,15,28,0.464285714285714,0.358974358974359
77,"Lycan",102,"Abaddon",9,7,16,0.5625,0.205128205128205
77,"Lycan",103,"Elder Titan",3,1,4,0.75,0.0512820512820513
77,"Lycan",104,"Legion Commander",17,30,47,0.361702127659574,0.602564102564103
77,"Lycan",105,"Techies",2,5,7,0.285714285714286,0.0897435897435897
77,"Lycan",106,"Ember Spirit",26,23,49,0.530612244897959,0.628205128205128
77,"Lycan",107,"Earth Spirit",4,12,16,0.25,0.205128205128205
77,"Lycan",109,"Terrorblade",9,5,14,0.642857142857143,0.179487179487179
77,"Lycan",110,"Phoenix",11,9,20,0.55,0.256410256410256
77,"Lycan",111,"Oracle",5,4,9,0.555555555555556,0.115384615384615
77,"Lycan",112,"Winter Wyvern",27,22,49,0.551020408163265,0.628205128205128
78,"Brewmaster",79,"Shadow Demon",9,11,20,0.45,0.256410256410256
78,"Brewmaster",80,"Lone Druid",4,2,6,0.666666666666667,0.0769230769230769
78,"Brewmaster",81,"Chaos Knight",5,5,10,0.5,0.128205128205128
78,"Brewmaster",82,"Meepo",2,5,7,0.285714285714286,0.0897435897435897
78,"Brewmaster",83,"Treant Protector",7,2,9,0.777777777777778,0.115384615384615
78,"Brewmaster",84,"Ogre Magi",16,16,32,0.5,0.41025641025641
78,"Brewmaster",85,"Undying",16,18,34,0.470588235294118,0.435897435897436
78,"Brewmaster",86,"Rubick",38,44,82,0.463414634146341,1.05128205128205
78,"Brewmaster",87,"Disruptor",18,17,35,0.514285714285714,0.448717948717949
78,"Brewmaster",88,"Nyx Assassin",9,11,20,0.45,0.256410256410256
78,"Brewmaster",89,"Naga Siren",6,6,12,0.5,0.153846153846154
78,"Brewmaster",90,"Keeper of the Light",8,14,22,0.363636363636364,0.282051282051282
78,"Brewmaster",91,"Io",5,8,13,0.384615384615385,0.166666666666667
78,"Brewmaster",92,"Visage",2,5,7,0.285714285714286,0.0897435897435897
78,"Brewmaster",93,"Slark",33,26,59,0.559322033898305,0.756410256410256
78,"Brewmaster",94,"Medusa",7,6,13,0.538461538461538,0.166666666666667
78,"Brewmaster",95,"Troll Warlord",3,7,10,0.3,0.128205128205128
78,"Brewmaster",96,"Centaur Warrunner",8,6,14,0.571428571428571,0.179487179487179
78,"Brewmaster",97,"Magnus",4,4,8,0.5,0.102564102564103
78,"Brewmaster",98,"Timbersaw",6,9,15,0.4,0.192307692307692
78,"Brewmaster",99,"Bristleback",7,8,15,0.466666666666667,0.192307692307692
78,"Brewmaster",100,"Tusk",26,35,61,0.426229508196721,0.782051282051282
78,"Brewmaster",101,"Skywrath Mage",14,9,23,0.608695652173913,0.294871794871795
78,"Brewmaster",102,"Abaddon",9,12,21,0.428571428571429,0.269230769230769
78,"Brewmaster",103,"Elder Titan",1,3,4,0.25,0.0512820512820513
78,"Brewmaster",104,"Legion Commander",35,31,66,0.53030303030303,0.846153846153846
78,"Brewmaster",105,"Techies",5,1,6,0.833333333333333,0.0769230769230769
78,"Brewmaster",106,"Ember Spirit",23,20,43,0.534883720930233,0.551282051282051
78,"Brewmaster",107,"Earth Spirit",9,5,14,0.642857142857143,0.179487179487179
78,"Brewmaster",109,"Terrorblade",8,11,19,0.421052631578947,0.243589743589744
78,"Brewmaster",110,"Phoenix",4,10,14,0.285714285714286,0.179487179487179
78,"Brewmaster",111,"Oracle",4,0,4,1,0.0512820512820513
78,"Brewmaster",112,"Winter Wyvern",37,25,62,0.596774193548387,0.794871794871795
79,"Shadow Demon",80,"Lone Druid",2,2,4,0.5,0.0512820512820513
79,"Shadow Demon",81,"Chaos Knight",13,18,31,0.419354838709677,0.397435897435897
79,"Shadow Demon",82,"Meepo",7,11,18,0.388888888888889,0.230769230769231
79,"Shadow Demon",83,"Treant Protector",4,5,9,0.444444444444444,0.115384615384615
79,"Shadow Demon",84,"Ogre Magi",11,13,24,0.458333333333333,0.307692307692308
79,"Shadow Demon",85,"Undying",27,27,54,0.5,0.692307692307692
79,"Shadow Demon",86,"Rubick",19,24,43,0.441860465116279,0.551282051282051
79,"Shadow Demon",87,"Disruptor",8,14,22,0.363636363636364,0.282051282051282
79,"Shadow Demon",88,"Nyx Assassin",14,15,29,0.482758620689655,0.371794871794872
79,"Shadow Demon",89,"Naga Siren",1,10,11,0.0909090909090909,0.141025641025641
79,"Shadow Demon",90,"Keeper of the Light",5,7,12,0.416666666666667,0.153846153846154
79,"Shadow Demon",91,"Io",1,7,8,0.125,0.102564102564103
79,"Shadow Demon",92,"Visage",5,2,7,0.714285714285714,0.0897435897435897
79,"Shadow Demon",93,"Slark",32,48,80,0.4,1.02564102564103
79,"Shadow Demon",94,"Medusa",7,12,19,0.368421052631579,0.243589743589744
79,"Shadow Demon",95,"Troll Warlord",5,10,15,0.333333333333333,0.192307692307692
79,"Shadow Demon",96,"Centaur Warrunner",12,11,23,0.521739130434783,0.294871794871795
79,"Shadow Demon",97,"Magnus",18,21,39,0.461538461538462,0.5
79,"Shadow Demon",98,"Timbersaw",9,21,30,0.3,0.384615384615385
79,"Shadow Demon",99,"Bristleback",8,17,25,0.32,0.320512820512821
79,"Shadow Demon",100,"Tusk",32,45,77,0.415584415584416,0.987179487179487
79,"Shadow Demon",101,"Skywrath Mage",3,14,17,0.176470588235294,0.217948717948718
79,"Shadow Demon",102,"Abaddon",13,22,35,0.371428571428571,0.448717948717949
79,"Shadow Demon",103,"Elder Titan",3,6,9,0.333333333333333,0.115384615384615
79,"Shadow Demon",104,"Legion Commander",29,45,74,0.391891891891892,0.948717948717949
79,"Shadow Demon",105,"Techies",1,4,5,0.2,0.0641025641025641
79,"Shadow Demon",106,"Ember Spirit",40,60,100,0.4,1.28205128205128
79,"Shadow Demon",107,"Earth Spirit",12,19,31,0.387096774193548,0.397435897435897
79,"Shadow Demon",109,"Terrorblade",6,11,17,0.352941176470588,0.217948717948718
79,"Shadow Demon",110,"Phoenix",8,21,29,0.275862068965517,0.371794871794872
79,"Shadow Demon",111,"Oracle",1,4,5,0.2,0.0641025641025641
79,"Shadow Demon",112,"Winter Wyvern",17,26,43,0.395348837209302,0.551282051282051
80,"Lone Druid",81,"Chaos Knight",7,8,15,0.466666666666667,0.192307692307692
80,"Lone Druid",82,"Meepo",5,7,12,0.416666666666667,0.153846153846154
80,"Lone Druid",83,"Treant Protector",4,6,10,0.4,0.128205128205128
80,"Lone Druid",84,"Ogre Magi",21,19,40,0.525,0.512820512820513
80,"Lone Druid",85,"Undying",13,16,29,0.448275862068966,0.371794871794872
80,"Lone Druid",86,"Rubick",27,35,62,0.435483870967742,0.794871794871795
80,"Lone Druid",87,"Disruptor",15,21,36,0.416666666666667,0.461538461538462
80,"Lone Druid",88,"Nyx Assassin",7,10,17,0.411764705882353,0.217948717948718
80,"Lone Druid",89,"Naga Siren",6,4,10,0.6,0.128205128205128
80,"Lone Druid",90,"Keeper of the Light",9,12,21,0.428571428571429,0.269230769230769
80,"Lone Druid",91,"Io",5,9,14,0.357142857142857,0.179487179487179
80,"Lone Druid",92,"Visage",1,3,4,0.25,0.0512820512820513
80,"Lone Druid",93,"Slark",14,30,44,0.318181818181818,0.564102564102564
80,"Lone Druid",94,"Medusa",10,7,17,0.588235294117647,0.217948717948718
80,"Lone Druid",95,"Troll Warlord",6,10,16,0.375,0.205128205128205
80,"Lone Druid",96,"Centaur Warrunner",6,7,13,0.461538461538462,0.166666666666667
80,"Lone Druid",97,"Magnus",4,8,12,0.333333333333333,0.153846153846154
80,"Lone Druid",98,"Timbersaw",8,8,16,0.5,0.205128205128205
80,"Lone Druid",99,"Bristleback",9,17,26,0.346153846153846,0.333333333333333
80,"Lone Druid",100,"Tusk",24,27,51,0.470588235294118,0.653846153846154
80,"Lone Druid",101,"Skywrath Mage",8,12,20,0.4,0.256410256410256
80,"Lone Druid",102,"Abaddon",9,11,20,0.45,0.256410256410256
80,"Lone Druid",103,"Elder Titan",4,3,7,0.571428571428571,0.0897435897435897
80,"Lone Druid",104,"Legion Commander",21,32,53,0.39622641509434,0.67948717948718
80,"Lone Druid",105,"Techies",3,5,8,0.375,0.102564102564103
80,"Lone Druid",106,"Ember Spirit",29,35,64,0.453125,0.82051282051282
80,"Lone Druid",107,"Earth Spirit",6,12,18,0.333333333333333,0.230769230769231
80,"Lone Druid",109,"Terrorblade",4,3,7,0.571428571428571,0.0897435897435897
80,"Lone Druid",110,"Phoenix",10,13,23,0.434782608695652,0.294871794871795
80,"Lone Druid",111,"Oracle",5,8,13,0.384615384615385,0.166666666666667
80,"Lone Druid",112,"Winter Wyvern",24,32,56,0.428571428571429,0.717948717948718
81,"Chaos Knight",82,"Meepo",7,8,15,0.466666666666667,0.192307692307692
81,"Chaos Knight",83,"Treant Protector",10,14,24,0.416666666666667,0.307692307692308
81,"Chaos Knight",84,"Ogre Magi",38,36,74,0.513513513513513,0.948717948717949
81,"Chaos Knight",85,"Undying",55,43,98,0.561224489795918,1.25641025641026
81,"Chaos Knight",86,"Rubick",62,68,130,0.476923076923077,1.66666666666667
81,"Chaos Knight",87,"Disruptor",43,43,86,0.5,1.1025641025641
81,"Chaos Knight",88,"Nyx Assassin",28,20,48,0.583333333333333,0.615384615384615
81,"Chaos Knight",89,"Naga Siren",6,7,13,0.461538461538462,0.166666666666667
81,"Chaos Knight",90,"Keeper of the Light",26,29,55,0.472727272727273,0.705128205128205
81,"Chaos Knight",91,"Io",34,59,93,0.365591397849462,1.19230769230769
81,"Chaos Knight",92,"Visage",6,13,19,0.315789473684211,0.243589743589744
81,"Chaos Knight",93,"Slark",38,36,74,0.513513513513513,0.948717948717949
81,"Chaos Knight",94,"Medusa",23,7,30,0.766666666666667,0.384615384615385
81,"Chaos Knight",95,"Troll Warlord",11,9,20,0.55,0.256410256410256
81,"Chaos Knight",96,"Centaur Warrunner",17,14,31,0.548387096774194,0.397435897435897
81,"Chaos Knight",97,"Magnus",27,27,54,0.5,0.692307692307692
81,"Chaos Knight",98,"Timbersaw",20,25,45,0.444444444444444,0.576923076923077
81,"Chaos Knight",99,"Bristleback",26,45,71,0.366197183098592,0.91025641025641
81,"Chaos Knight",100,"Tusk",81,76,157,0.515923566878981,2.01282051282051
81,"Chaos Knight",101,"Skywrath Mage",20,31,51,0.392156862745098,0.653846153846154
81,"Chaos Knight",102,"Abaddon",28,21,49,0.571428571428571,0.628205128205128
81,"Chaos Knight",103,"Elder Titan",5,11,16,0.3125,0.205128205128205
81,"Chaos Knight",104,"Legion Commander",54,72,126,0.428571428571429,1.61538461538462
81,"Chaos Knight",105,"Techies",7,7,14,0.5,0.179487179487179
81,"Chaos Knight",106,"Ember Spirit",31,39,70,0.442857142857143,0.897435897435897
81,"Chaos Knight",107,"Earth Spirit",26,14,40,0.65,0.512820512820513
81,"Chaos Knight",109,"Terrorblade",8,11,19,0.421052631578947,0.243589743589744
81,"Chaos Knight",110,"Phoenix",27,30,57,0.473684210526316,0.730769230769231
81,"Chaos Knight",111,"Oracle",12,6,18,0.666666666666667,0.230769230769231
81,"Chaos Knight",112,"Winter Wyvern",56,65,121,0.462809917355372,1.55128205128205
82,"Meepo",83,"Treant Protector",14,7,21,0.666666666666667,0.269230769230769
82,"Meepo",84,"Ogre Magi",24,39,63,0.380952380952381,0.807692307692308
82,"Meepo",85,"Undying",41,21,62,0.661290322580645,0.794871794871795
82,"Meepo",86,"Rubick",46,50,96,0.479166666666667,1.23076923076923
82,"Meepo",87,"Disruptor",32,36,68,0.470588235294118,0.871794871794872
82,"Meepo",88,"Nyx Assassin",6,12,18,0.333333333333333,0.230769230769231
82,"Meepo",89,"Naga Siren",4,8,12,0.333333333333333,0.153846153846154
82,"Meepo",90,"Keeper of the Light",10,20,30,0.333333333333333,0.384615384615385
82,"Meepo",91,"Io",4,11,15,0.266666666666667,0.192307692307692
82,"Meepo",92,"Visage",7,7,14,0.5,0.179487179487179
82,"Meepo",93,"Slark",25,51,76,0.328947368421053,0.974358974358974
82,"Meepo",94,"Medusa",12,15,27,0.444444444444444,0.346153846153846
82,"Meepo",95,"Troll Warlord",11,14,25,0.44,0.320512820512821
82,"Meepo",96,"Centaur Warrunner",10,8,18,0.555555555555556,0.230769230769231
82,"Meepo",97,"Magnus",13,22,35,0.371428571428571,0.448717948717949
82,"Meepo",98,"Timbersaw",15,16,31,0.483870967741935,0.397435897435897
82,"Meepo",99,"Bristleback",27,24,51,0.529411764705882,0.653846153846154
82,"Meepo",100,"Tusk",81,66,147,0.551020408163265,1.88461538461538
82,"Meepo",101,"Skywrath Mage",24,18,42,0.571428571428571,0.538461538461538
82,"Meepo",102,"Abaddon",12,17,29,0.413793103448276,0.371794871794872
82,"Meepo",103,"Elder Titan",5,5,10,0.5,0.128205128205128
82,"Meepo",104,"Legion Commander",37,60,97,0.381443298969072,1.24358974358974
82,"Meepo",105,"Techies",5,18,23,0.217391304347826,0.294871794871795
82,"Meepo",106,"Ember Spirit",33,43,76,0.434210526315789,0.974358974358974
82,"Meepo",107,"Earth Spirit",24,21,45,0.533333333333333,0.576923076923077
82,"Meepo",109,"Terrorblade",6,6,12,0.5,0.153846153846154
82,"Meepo",110,"Phoenix",26,16,42,0.619047619047619,0.538461538461538
82,"Meepo",111,"Oracle",10,8,18,0.555555555555556,0.230769230769231
82,"Meepo",112,"Winter Wyvern",62,43,105,0.59047619047619,1.34615384615385
83,"Treant Protector",84,"Ogre Magi",17,12,29,0.586206896551724,0.371794871794872
83,"Treant Protector",85,"Undying",34,17,51,0.666666666666667,0.653846153846154
83,"Treant Protector",86,"Rubick",30,38,68,0.441176470588235,0.871794871794872
83,"Treant Protector",87,"Disruptor",17,15,32,0.53125,0.41025641025641
83,"Treant Protector",88,"Nyx Assassin",21,8,29,0.724137931034483,0.371794871794872
83,"Treant Protector",89,"Naga Siren",9,5,14,0.642857142857143,0.179487179487179
83,"Treant Protector",90,"Keeper of the Light",7,11,18,0.388888888888889,0.230769230769231
83,"Treant Protector",91,"Io",8,11,19,0.421052631578947,0.243589743589744
83,"Treant Protector",92,"Visage",8,4,12,0.666666666666667,0.153846153846154
83,"Treant Protector",93,"Slark",61,65,126,0.484126984126984,1.61538461538462
83,"Treant Protector",94,"Medusa",15,14,29,0.517241379310345,0.371794871794872
83,"Treant Protector",95,"Troll Warlord",5,10,15,0.333333333333333,0.192307692307692
83,"Treant Protector",96,"Centaur Warrunner",13,6,19,0.684210526315789,0.243589743589744
83,"Treant Protector",97,"Magnus",21,26,47,0.446808510638298,0.602564102564103
83,"Treant Protector",98,"Timbersaw",17,22,39,0.435897435897436,0.5
83,"Treant Protector",99,"Bristleback",28,15,43,0.651162790697674,0.551282051282051
83,"Treant Protector",100,"Tusk",63,40,103,0.611650485436893,1.32051282051282
83,"Treant Protector",101,"Skywrath Mage",7,12,19,0.368421052631579,0.243589743589744
83,"Treant Protector",102,"Abaddon",24,19,43,0.558139534883721,0.551282051282051
83,"Treant Protector",103,"Elder Titan",7,2,9,0.777777777777778,0.115384615384615
83,"Treant Protector",104,"Legion Commander",51,51,102,0.5,1.30769230769231
83,"Treant Protector",105,"Techies",3,8,11,0.272727272727273,0.141025641025641
83,"Treant Protector",106,"Ember Spirit",48,47,95,0.505263157894737,1.21794871794872
83,"Treant Protector",107,"Earth Spirit",16,9,25,0.64,0.320512820512821
83,"Treant Protector",109,"Terrorblade",11,5,16,0.6875,0.205128205128205
83,"Treant Protector",110,"Phoenix",24,23,47,0.51063829787234,0.602564102564103
83,"Treant Protector",111,"Oracle",5,7,12,0.416666666666667,0.153846153846154
83,"Treant Protector",112,"Winter Wyvern",31,26,57,0.543859649122807,0.730769230769231
84,"Ogre Magi",85,"Undying",76,68,144,0.527777777777778,1.84615384615385
84,"Ogre Magi",86,"Rubick",90,76,166,0.542168674698795,2.12820512820513
84,"Ogre Magi",87,"Disruptor",50,47,97,0.515463917525773,1.24358974358974
84,"Ogre Magi",88,"Nyx Assassin",45,39,84,0.535714285714286,1.07692307692308
84,"Ogre Magi",89,"Naga Siren",13,12,25,0.52,0.320512820512821
84,"Ogre Magi",90,"Keeper of the Light",25,25,50,0.5,0.641025641025641
84,"Ogre Magi",91,"Io",13,19,32,0.40625,0.41025641025641
84,"Ogre Magi",92,"Visage",7,9,16,0.4375,0.205128205128205
84,"Ogre Magi",93,"Slark",139,162,301,0.461794019933555,3.85897435897436
84,"Ogre Magi",94,"Medusa",55,58,113,0.486725663716814,1.44871794871795
84,"Ogre Magi",95,"Troll Warlord",39,30,69,0.565217391304348,0.884615384615385
84,"Ogre Magi",96,"Centaur Warrunner",38,37,75,0.506666666666667,0.961538461538462
84,"Ogre Magi",97,"Magnus",40,47,87,0.459770114942529,1.11538461538462
84,"Ogre Magi",98,"Timbersaw",33,51,84,0.392857142857143,1.07692307692308
84,"Ogre Magi",99,"Bristleback",63,73,136,0.463235294117647,1.74358974358974
84,"Ogre Magi",100,"Tusk",141,136,277,0.509025270758123,3.55128205128205
84,"Ogre Magi",101,"Skywrath Mage",26,39,65,0.4,0.833333333333333
84,"Ogre Magi",102,"Abaddon",43,28,71,0.605633802816901,0.91025641025641
84,"Ogre Magi",103,"Elder Titan",11,10,21,0.523809523809524,0.269230769230769
84,"Ogre Magi",104,"Legion Commander",147,139,286,0.513986013986014,3.66666666666667
84,"Ogre Magi",105,"Techies",10,16,26,0.384615384615385,0.333333333333333
84,"Ogre Magi",106,"Ember Spirit",108,120,228,0.473684210526316,2.92307692307692
84,"Ogre Magi",107,"Earth Spirit",42,36,78,0.538461538461538,1
84,"Ogre Magi",109,"Terrorblade",31,27,58,0.53448275862069,0.743589743589744
84,"Ogre Magi",110,"Phoenix",47,54,101,0.465346534653465,1.29487179487179
84,"Ogre Magi",111,"Oracle",8,7,15,0.533333333333333,0.192307692307692
84,"Ogre Magi",112,"Winter Wyvern",94,80,174,0.540229885057471,2.23076923076923
85,"Undying",86,"Rubick",185,148,333,0.555555555555556,4.26923076923077
85,"Undying",87,"Disruptor",126,92,218,0.577981651376147,2.79487179487179
85,"Undying",88,"Nyx Assassin",34,45,79,0.430379746835443,1.01282051282051
85,"Undying",89,"Naga Siren",22,19,41,0.536585365853659,0.525641025641026
85,"Undying",90,"Keeper of the Light",44,37,81,0.54320987654321,1.03846153846154
85,"Undying",91,"Io",27,30,57,0.473684210526316,0.730769230769231
85,"Undying",92,"Visage",22,15,37,0.594594594594595,0.474358974358974
85,"Undying",93,"Slark",238,197,435,0.547126436781609,5.57692307692308
85,"Undying",94,"Medusa",86,36,122,0.704918032786885,1.56410256410256
85,"Undying",95,"Troll Warlord",48,42,90,0.533333333333333,1.15384615384615
85,"Undying",96,"Centaur Warrunner",22,9,31,0.709677419354839,0.397435897435897
85,"Undying",97,"Magnus",74,56,130,0.569230769230769,1.66666666666667
85,"Undying",98,"Timbersaw",37,39,76,0.486842105263158,0.974358974358974
85,"Undying",99,"Bristleback",59,43,102,0.57843137254902,1.30769230769231
85,"Undying",100,"Tusk",302,216,518,0.583011583011583,6.64102564102564
85,"Undying",101,"Skywrath Mage",40,58,98,0.408163265306122,1.25641025641026
85,"Undying",102,"Abaddon",64,33,97,0.65979381443299,1.24358974358974
85,"Undying",103,"Elder Titan",19,8,27,0.703703703703704,0.346153846153846
85,"Undying",104,"Legion Commander",186,130,316,0.588607594936709,4.05128205128205
85,"Undying",105,"Techies",12,10,22,0.545454545454545,0.282051282051282
85,"Undying",106,"Ember Spirit",233,161,394,0.591370558375635,5.05128205128205
85,"Undying",107,"Earth Spirit",69,38,107,0.644859813084112,1.37179487179487
85,"Undying",109,"Terrorblade",48,23,71,0.676056338028169,0.91025641025641
85,"Undying",110,"Phoenix",66,37,103,0.640776699029126,1.32051282051282
85,"Undying",111,"Oracle",24,14,38,0.631578947368421,0.487179487179487
85,"Undying",112,"Winter Wyvern",213,133,346,0.615606936416185,4.43589743589744
86,"Rubick",87,"Disruptor",78,83,161,0.484472049689441,2.06410256410256
86,"Rubick",88,"Nyx Assassin",70,91,161,0.434782608695652,2.06410256410256
86,"Rubick",89,"Naga Siren",28,37,65,0.430769230769231,0.833333333333333
86,"Rubick",90,"Keeper of the Light",32,31,63,0.507936507936508,0.807692307692308
86,"Rubick",91,"Io",24,58,82,0.292682926829268,1.05128205128205
86,"Rubick",92,"Visage",13,21,34,0.382352941176471,0.435897435897436
86,"Rubick",93,"Slark",261,339,600,0.435,7.69230769230769
86,"Rubick",94,"Medusa",68,79,147,0.462585034013605,1.88461538461538
86,"Rubick",95,"Troll Warlord",51,60,111,0.459459459459459,1.42307692307692
86,"Rubick",96,"Centaur Warrunner",62,48,110,0.563636363636364,1.41025641025641
86,"Rubick",97,"Magnus",95,131,226,0.420353982300885,2.8974358974359
86,"Rubick",98,"Timbersaw",79,120,199,0.396984924623116,2.55128205128205
86,"Rubick",99,"Bristleback",112,152,264,0.424242424242424,3.38461538461538
86,"Rubick",100,"Tusk",309,326,635,0.486614173228346,8.14102564102564
86,"Rubick",101,"Skywrath Mage",46,78,124,0.370967741935484,1.58974358974359
86,"Rubick",102,"Abaddon",81,77,158,0.512658227848101,2.02564102564103
86,"Rubick",103,"Elder Titan",24,26,50,0.48,0.641025641025641
86,"Rubick",104,"Legion Commander",204,305,509,0.400785854616896,6.52564102564103
86,"Rubick",105,"Techies",23,29,52,0.442307692307692,0.666666666666667
86,"Rubick",106,"Ember Spirit",249,309,558,0.446236559139785,7.15384615384615
86,"Rubick",107,"Earth Spirit",72,97,169,0.42603550295858,2.16666666666667
86,"Rubick",109,"Terrorblade",53,60,113,0.469026548672566,1.44871794871795
86,"Rubick",110,"Phoenix",82,109,191,0.429319371727749,2.44871794871795
86,"Rubick",111,"Oracle",15,20,35,0.428571428571429,0.448717948717949
86,"Rubick",112,"Winter Wyvern",106,150,256,0.4140625,3.28205128205128
87,"Disruptor",88,"Nyx Assassin",44,48,92,0.478260869565217,1.17948717948718
87,"Disruptor",89,"Naga Siren",18,18,36,0.5,0.461538461538462
87,"Disruptor",90,"Keeper of the Light",15,14,29,0.517241379310345,0.371794871794872
87,"Disruptor",91,"Io",18,17,35,0.514285714285714,0.448717948717949
87,"Disruptor",92,"Visage",16,9,25,0.64,0.320512820512821
87,"Disruptor",93,"Slark",169,148,317,0.533123028391167,4.06410256410256
87,"Disruptor",94,"Medusa",47,47,94,0.5,1.20512820512821
87,"Disruptor",95,"Troll Warlord",35,23,58,0.603448275862069,0.743589743589744
87,"Disruptor",96,"Centaur Warrunner",36,36,72,0.5,0.923076923076923
87,"Disruptor",97,"Magnus",72,87,159,0.452830188679245,2.03846153846154
87,"Disruptor",98,"Timbersaw",44,50,94,0.468085106382979,1.20512820512821
87,"Disruptor",99,"Bristleback",72,76,148,0.486486486486487,1.8974358974359
87,"Disruptor",100,"Tusk",181,178,359,0.504178272980501,4.6025641025641
87,"Disruptor",101,"Skywrath Mage",28,31,59,0.474576271186441,0.756410256410256
87,"Disruptor",102,"Abaddon",52,44,96,0.541666666666667,1.23076923076923
87,"Disruptor",103,"Elder Titan",14,22,36,0.388888888888889,0.461538461538462
87,"Disruptor",104,"Legion Commander",167,140,307,0.543973941368078,3.93589743589744
87,"Disruptor",105,"Techies",18,12,30,0.6,0.384615384615385
87,"Disruptor",106,"Ember Spirit",169,169,338,0.5,4.33333333333333
87,"Disruptor",107,"Earth Spirit",52,42,94,0.553191489361702,1.20512820512821
87,"Disruptor",109,"Terrorblade",29,30,59,0.491525423728814,0.756410256410256
87,"Disruptor",110,"Phoenix",57,60,117,0.487179487179487,1.5
87,"Disruptor",111,"Oracle",10,15,25,0.4,0.320512820512821
87,"Disruptor",112,"Winter Wyvern",79,88,167,0.473053892215569,2.14102564102564
88,"Nyx Assassin",89,"Naga Siren",11,9,20,0.55,0.256410256410256
88,"Nyx Assassin",90,"Keeper of the Light",15,29,44,0.340909090909091,0.564102564102564
88,"Nyx Assassin",91,"Io",13,14,27,0.481481481481481,0.346153846153846
88,"Nyx Assassin",92,"Visage",10,8,18,0.555555555555556,0.230769230769231
88,"Nyx Assassin",93,"Slark",85,89,174,0.488505747126437,2.23076923076923
88,"Nyx Assassin",94,"Medusa",29,25,54,0.537037037037037,0.692307692307692
88,"Nyx Assassin",95,"Troll Warlord",11,21,32,0.34375,0.41025641025641
88,"Nyx Assassin",96,"Centaur Warrunner",6,10,16,0.375,0.205128205128205
88,"Nyx Assassin",97,"Magnus",33,33,66,0.5,0.846153846153846
88,"Nyx Assassin",98,"Timbersaw",15,21,36,0.416666666666667,0.461538461538462
88,"Nyx Assassin",99,"Bristleback",17,25,42,0.404761904761905,0.538461538461538
88,"Nyx Assassin",100,"Tusk",71,90,161,0.440993788819876,2.06410256410256
88,"Nyx Assassin",101,"Skywrath Mage",26,35,61,0.426229508196721,0.782051282051282
88,"Nyx Assassin",102,"Abaddon",35,24,59,0.593220338983051,0.756410256410256
88,"Nyx Assassin",103,"Elder Titan",6,11,17,0.352941176470588,0.217948717948718
88,"Nyx Assassin",104,"Legion Commander",81,109,190,0.426315789473684,2.43589743589744
88,"Nyx Assassin",105,"Techies",6,18,24,0.25,0.307692307692308
88,"Nyx Assassin",106,"Ember Spirit",72,95,167,0.431137724550898,2.14102564102564
88,"Nyx Assassin",107,"Earth Spirit",16,19,35,0.457142857142857,0.448717948717949
88,"Nyx Assassin",109,"Terrorblade",22,12,34,0.647058823529412,0.435897435897436
88,"Nyx Assassin",110,"Phoenix",22,17,39,0.564102564102564,0.5
88,"Nyx Assassin",111,"Oracle",7,11,18,0.388888888888889,0.230769230769231
88,"Nyx Assassin",112,"Winter Wyvern",72,79,151,0.47682119205298,1.93589743589744
89,"Naga Siren",90,"Keeper of the Light",9,16,25,0.36,0.320512820512821
89,"Naga Siren",91,"Io",2,10,12,0.166666666666667,0.153846153846154
89,"Naga Siren",92,"Visage",1,2,3,0.333333333333333,0.0384615384615385
89,"Naga Siren",93,"Slark",21,16,37,0.567567567567568,0.474358974358974
89,"Naga Siren",94,"Medusa",10,2,12,0.833333333333333,0.153846153846154
89,"Naga Siren",95,"Troll Warlord",1,3,4,0.25,0.0512820512820513
89,"Naga Siren",96,"Centaur Warrunner",5,8,13,0.384615384615385,0.166666666666667
89,"Naga Siren",97,"Magnus",11,19,30,0.366666666666667,0.384615384615385
89,"Naga Siren",98,"Timbersaw",8,5,13,0.615384615384615,0.166666666666667
89,"Naga Siren",99,"Bristleback",7,17,24,0.291666666666667,0.307692307692308
89,"Naga Siren",100,"Tusk",28,22,50,0.56,0.641025641025641
89,"Naga Siren",101,"Skywrath Mage",11,18,29,0.379310344827586,0.371794871794872
89,"Naga Siren",102,"Abaddon",12,12,24,0.5,0.307692307692308
89,"Naga Siren",103,"Elder Titan",5,3,8,0.625,0.102564102564103
89,"Naga Siren",104,"Legion Commander",35,28,63,0.555555555555556,0.807692307692308
89,"Naga Siren",105,"Techies",0,2,2,0,0.0256410256410256
89,"Naga Siren",106,"Ember Spirit",12,21,33,0.363636363636364,0.423076923076923
89,"Naga Siren",107,"Earth Spirit",5,18,23,0.217391304347826,0.294871794871795
89,"Naga Siren",109,"Terrorblade",4,5,9,0.444444444444444,0.115384615384615
89,"Naga Siren",110,"Phoenix",11,17,28,0.392857142857143,0.358974358974359
89,"Naga Siren",111,"Oracle",4,5,9,0.444444444444444,0.115384615384615
89,"Naga Siren",112,"Winter Wyvern",20,37,57,0.350877192982456,0.730769230769231
90,"Keeper of the Light",91,"Io",10,6,16,0.625,0.205128205128205
90,"Keeper of the Light",92,"Visage",9,5,14,0.642857142857143,0.179487179487179
90,"Keeper of the Light",93,"Slark",65,76,141,0.460992907801418,1.80769230769231
90,"Keeper of the Light",94,"Medusa",24,22,46,0.521739130434783,0.58974358974359
90,"Keeper of the Light",95,"Troll Warlord",8,9,17,0.470588235294118,0.217948717948718
90,"Keeper of the Light",96,"Centaur Warrunner",14,14,28,0.5,0.358974358974359
90,"Keeper of the Light",97,"Magnus",21,51,72,0.291666666666667,0.923076923076923
90,"Keeper of the Light",98,"Timbersaw",21,45,66,0.318181818181818,0.846153846153846
90,"Keeper of the Light",99,"Bristleback",34,58,92,0.369565217391304,1.17948717948718
90,"Keeper of the Light",100,"Tusk",59,74,133,0.443609022556391,1.70512820512821
90,"Keeper of the Light",101,"Skywrath Mage",14,19,33,0.424242424242424,0.423076923076923
90,"Keeper of the Light",102,"Abaddon",28,17,45,0.622222222222222,0.576923076923077
90,"Keeper of the Light",103,"Elder Titan",6,2,8,0.75,0.102564102564103
90,"Keeper of the Light",104,"Legion Commander",60,79,139,0.431654676258993,1.78205128205128
90,"Keeper of the Light",105,"Techies",10,13,23,0.434782608695652,0.294871794871795
90,"Keeper of the Light",106,"Ember Spirit",66,79,145,0.455172413793103,1.85897435897436
90,"Keeper of the Light",107,"Earth Spirit",21,20,41,0.51219512195122,0.525641025641026
90,"Keeper of the Light",109,"Terrorblade",15,14,29,0.517241379310345,0.371794871794872
90,"Keeper of the Light",110,"Phoenix",24,17,41,0.585365853658537,0.525641025641026
90,"Keeper of the Light",111,"Oracle",4,6,10,0.4,0.128205128205128
90,"Keeper of the Light",112,"Winter Wyvern",30,21,51,0.588235294117647,0.653846153846154
91,"Io",92,"Visage",5,4,9,0.555555555555556,0.115384615384615
91,"Io",93,"Slark",46,61,107,0.429906542056075,1.37179487179487
91,"Io",94,"Medusa",9,15,24,0.375,0.307692307692308
91,"Io",95,"Troll Warlord",9,11,20,0.45,0.256410256410256
91,"Io",96,"Centaur Warrunner",8,15,23,0.347826086956522,0.294871794871795
91,"Io",97,"Magnus",17,17,34,0.5,0.435897435897436
91,"Io",98,"Timbersaw",17,14,31,0.548387096774194,0.397435897435897
91,"Io",99,"Bristleback",39,52,91,0.428571428571429,1.16666666666667
91,"Io",100,"Tusk",38,59,97,0.391752577319588,1.24358974358974
91,"Io",101,"Skywrath Mage",12,14,26,0.461538461538462,0.333333333333333
91,"Io",102,"Abaddon",17,11,28,0.607142857142857,0.358974358974359
91,"Io",103,"Elder Titan",6,9,15,0.4,0.192307692307692
91,"Io",104,"Legion Commander",47,64,111,0.423423423423423,1.42307692307692
91,"Io",105,"Techies",3,8,11,0.272727272727273,0.141025641025641
91,"Io",106,"Ember Spirit",29,50,79,0.367088607594937,1.01282051282051
91,"Io",107,"Earth Spirit",15,17,32,0.46875,0.41025641025641
91,"Io",109,"Terrorblade",6,6,12,0.5,0.153846153846154
91,"Io",110,"Phoenix",12,19,31,0.387096774193548,0.397435897435897
91,"Io",111,"Oracle",3,8,11,0.272727272727273,0.141025641025641
91,"Io",112,"Winter Wyvern",35,28,63,0.555555555555556,0.807692307692308
92,"Visage",93,"Slark",33,28,61,0.540983606557377,0.782051282051282
92,"Visage",94,"Medusa",4,7,11,0.363636363636364,0.141025641025641
92,"Visage",95,"Troll Warlord",5,2,7,0.714285714285714,0.0897435897435897
92,"Visage",96,"Centaur Warrunner",9,6,15,0.6,0.192307692307692
92,"Visage",97,"Magnus",13,11,24,0.541666666666667,0.307692307692308
92,"Visage",98,"Timbersaw",12,13,25,0.48,0.320512820512821
92,"Visage",99,"Bristleback",9,14,23,0.391304347826087,0.294871794871795
92,"Visage",100,"Tusk",35,29,64,0.546875,0.82051282051282
92,"Visage",101,"Skywrath Mage",4,5,9,0.444444444444444,0.115384615384615
92,"Visage",102,"Abaddon",19,9,28,0.678571428571429,0.358974358974359
92,"Visage",103,"Elder Titan",4,5,9,0.444444444444444,0.115384615384615
92,"Visage",104,"Legion Commander",31,24,55,0.563636363636364,0.705128205128205
92,"Visage",105,"Techies",2,1,3,0.666666666666667,0.0384615384615385
92,"Visage",106,"Ember Spirit",33,36,69,0.478260869565217,0.884615384615385
92,"Visage",107,"Earth Spirit",8,7,15,0.533333333333333,0.192307692307692
92,"Visage",109,"Terrorblade",10,8,18,0.555555555555556,0.230769230769231
92,"Visage",110,"Phoenix",25,14,39,0.641025641025641,0.5
92,"Visage",111,"Oracle",1,5,6,0.166666666666667,0.0769230769230769
92,"Visage",112,"Winter Wyvern",20,11,31,0.645161290322581,0.397435897435897
93,"Slark",94,"Medusa",49,38,87,0.563218390804598,1.11538461538462
93,"Slark",95,"Troll Warlord",30,35,65,0.461538461538462,0.833333333333333
93,"Slark",96,"Centaur Warrunner",61,66,127,0.480314960629921,1.62820512820513
93,"Slark",97,"Magnus",83,102,185,0.448648648648649,2.37179487179487
93,"Slark",98,"Timbersaw",77,99,176,0.4375,2.25641025641026
93,"Slark",99,"Bristleback",91,138,229,0.397379912663755,2.93589743589744
93,"Slark",100,"Tusk",329,365,694,0.474063400576369,8.8974358974359
93,"Slark",101,"Skywrath Mage",112,111,223,0.502242152466368,2.85897435897436
93,"Slark",102,"Abaddon",123,88,211,0.582938388625592,2.70512820512821
93,"Slark",103,"Elder Titan",27,25,52,0.519230769230769,0.666666666666667
93,"Slark",104,"Legion Commander",236,274,510,0.462745098039216,6.53846153846154
93,"Slark",105,"Techies",25,43,68,0.367647058823529,0.871794871794872
93,"Slark",106,"Ember Spirit",151,166,317,0.476340694006309,4.06410256410256
93,"Slark",107,"Earth Spirit",109,98,207,0.526570048309179,2.65384615384615
93,"Slark",109,"Terrorblade",23,22,45,0.511111111111111,0.576923076923077
93,"Slark",110,"Phoenix",92,83,175,0.525714285714286,2.24358974358974
93,"Slark",111,"Oracle",34,42,76,0.447368421052632,0.974358974358974
93,"Slark",112,"Winter Wyvern",232,290,522,0.444444444444444,6.69230769230769
94,"Medusa",95,"Troll Warlord",12,12,24,0.5,0.307692307692308
94,"Medusa",96,"Centaur Warrunner",23,17,40,0.575,0.512820512820513
94,"Medusa",97,"Magnus",30,42,72,0.416666666666667,0.923076923076923
94,"Medusa",98,"Timbersaw",12,29,41,0.292682926829268,0.525641025641026
94,"Medusa",99,"Bristleback",36,37,73,0.493150684931507,0.935897435897436
94,"Medusa",100,"Tusk",83,83,166,0.5,2.12820512820513
94,"Medusa",101,"Skywrath Mage",21,36,57,0.368421052631579,0.730769230769231
94,"Medusa",102,"Abaddon",35,19,54,0.648148148148148,0.692307692307692
94,"Medusa",103,"Elder Titan",10,6,16,0.625,0.205128205128205
94,"Medusa",104,"Legion Commander",96,91,187,0.513368983957219,2.3974358974359
94,"Medusa",105,"Techies",18,13,31,0.580645161290323,0.397435897435897
94,"Medusa",106,"Ember Spirit",52,58,110,0.472727272727273,1.41025641025641
94,"Medusa",107,"Earth Spirit",23,16,39,0.58974358974359,0.5
94,"Medusa",109,"Terrorblade",14,8,22,0.636363636363636,0.282051282051282
94,"Medusa",110,"Phoenix",38,32,70,0.542857142857143,0.897435897435897
94,"Medusa",111,"Oracle",6,6,12,0.5,0.153846153846154
94,"Medusa",112,"Winter Wyvern",59,76,135,0.437037037037037,1.73076923076923
95,"Troll Warlord",96,"Centaur Warrunner",9,20,29,0.310344827586207,0.371794871794872
95,"Troll Warlord",97,"Magnus",21,31,52,0.403846153846154,0.666666666666667
95,"Troll Warlord",98,"Timbersaw",13,15,28,0.464285714285714,0.358974358974359
95,"Troll Warlord",99,"Bristleback",31,32,63,0.492063492063492,0.807692307692308
95,"Troll Warlord",100,"Tusk",57,57,114,0.5,1.46153846153846
95,"Troll Warlord",101,"Skywrath Mage",15,23,38,0.394736842105263,0.487179487179487
95,"Troll Warlord",102,"Abaddon",16,31,47,0.340425531914894,0.602564102564103
95,"Troll Warlord",103,"Elder Titan",5,6,11,0.454545454545455,0.141025641025641
95,"Troll Warlord",104,"Legion Commander",42,72,114,0.368421052631579,1.46153846153846
95,"Troll Warlord",105,"Techies",7,5,12,0.583333333333333,0.153846153846154
95,"Troll Warlord",106,"Ember Spirit",33,34,67,0.492537313432836,0.858974358974359
95,"Troll Warlord",107,"Earth Spirit",14,14,28,0.5,0.358974358974359
95,"Troll Warlord",109,"Terrorblade",4,4,8,0.5,0.102564102564103
95,"Troll Warlord",110,"Phoenix",17,22,39,0.435897435897436,0.5
95,"Troll Warlord",111,"Oracle",4,8,12,0.333333333333333,0.153846153846154
95,"Troll Warlord",112,"Winter Wyvern",42,55,97,0.43298969072165,1.24358974358974
96,"Centaur Warrunner",97,"Magnus",12,9,21,0.571428571428571,0.269230769230769
96,"Centaur Warrunner",98,"Timbersaw",5,7,12,0.416666666666667,0.153846153846154
96,"Centaur Warrunner",99,"Bristleback",8,8,16,0.5,0.205128205128205
96,"Centaur Warrunner",100,"Tusk",80,69,149,0.536912751677852,1.91025641025641
96,"Centaur Warrunner",101,"Skywrath Mage",18,30,48,0.375,0.615384615384615
96,"Centaur Warrunner",102,"Abaddon",18,15,33,0.545454545454545,0.423076923076923
96,"Centaur Warrunner",103,"Elder Titan",0,6,6,0,0.0769230769230769
96,"Centaur Warrunner",104,"Legion Commander",65,63,128,0.5078125,1.64102564102564
96,"Centaur Warrunner",105,"Techies",7,5,12,0.583333333333333,0.153846153846154
96,"Centaur Warrunner",106,"Ember Spirit",58,53,111,0.522522522522523,1.42307692307692
96,"Centaur Warrunner",107,"Earth Spirit",9,16,25,0.36,0.320512820512821
96,"Centaur Warrunner",109,"Terrorblade",9,20,29,0.310344827586207,0.371794871794872
96,"Centaur Warrunner",110,"Phoenix",11,7,18,0.611111111111111,0.230769230769231
96,"Centaur Warrunner",111,"Oracle",6,2,8,0.75,0.102564102564103
96,"Centaur Warrunner",112,"Winter Wyvern",56,60,116,0.482758620689655,1.48717948717949
97,"Magnus",98,"Timbersaw",26,32,58,0.448275862068966,0.743589743589744
97,"Magnus",99,"Bristleback",22,36,58,0.379310344827586,0.743589743589744
97,"Magnus",100,"Tusk",107,134,241,0.443983402489627,3.08974358974359
97,"Magnus",101,"Skywrath Mage",27,60,87,0.310344827586207,1.11538461538462
97,"Magnus",102,"Abaddon",34,37,71,0.47887323943662,0.91025641025641
97,"Magnus",103,"Elder Titan",11,12,23,0.478260869565217,0.294871794871795
97,"Magnus",104,"Legion Commander",87,107,194,0.448453608247423,2.48717948717949
97,"Magnus",105,"Techies",20,32,52,0.384615384615385,0.666666666666667
97,"Magnus",106,"Ember Spirit",132,184,316,0.417721518987342,4.05128205128205
97,"Magnus",107,"Earth Spirit",24,25,49,0.489795918367347,0.628205128205128
97,"Magnus",109,"Terrorblade",13,13,26,0.5,0.333333333333333
97,"Magnus",110,"Phoenix",28,35,63,0.444444444444444,0.807692307692308
97,"Magnus",111,"Oracle",11,19,30,0.366666666666667,0.384615384615385
97,"Magnus",112,"Winter Wyvern",96,152,248,0.387096774193548,3.17948717948718
98,"Timbersaw",99,"Bristleback",11,24,35,0.314285714285714,0.448717948717949
98,"Timbersaw",100,"Tusk",78,103,181,0.430939226519337,2.32051282051282
98,"Timbersaw",101,"Skywrath Mage",28,37,65,0.430769230769231,0.833333333333333
98,"Timbersaw",102,"Abaddon",37,25,62,0.596774193548387,0.794871794871795
98,"Timbersaw",103,"Elder Titan",5,8,13,0.384615384615385,0.166666666666667
98,"Timbersaw",104,"Legion Commander",69,99,168,0.410714285714286,2.15384615384615
98,"Timbersaw",105,"Techies",8,14,22,0.363636363636364,0.282051282051282
98,"Timbersaw",106,"Ember Spirit",60,94,154,0.38961038961039,1.97435897435897
98,"Timbersaw",107,"Earth Spirit",18,24,42,0.428571428571429,0.538461538461538
98,"Timbersaw",109,"Terrorblade",9,17,26,0.346153846153846,0.333333333333333
98,"Timbersaw",110,"Phoenix",10,21,31,0.32258064516129,0.397435897435897
98,"Timbersaw",111,"Oracle",8,18,26,0.307692307692308,0.333333333333333
98,"Timbersaw",112,"Winter Wyvern",80,92,172,0.465116279069767,2.20512820512821
99,"Bristleback",100,"Tusk",87,100,187,0.46524064171123,2.3974358974359
99,"Bristleback",101,"Skywrath Mage",41,53,94,0.436170212765957,1.20512820512821
99,"Bristleback",102,"Abaddon",47,44,91,0.516483516483517,1.16666666666667
99,"Bristleback",103,"Elder Titan",7,12,19,0.368421052631579,0.243589743589744
99,"Bristleback",104,"Legion Commander",113,158,271,0.416974169741697,3.47435897435897
99,"Bristleback",105,"Techies",16,34,50,0.32,0.641025641025641
99,"Bristleback",106,"Ember Spirit",105,127,232,0.452586206896552,2.97435897435897
99,"Bristleback",107,"Earth Spirit",29,24,53,0.547169811320755,0.67948717948718
99,"Bristleback",109,"Terrorblade",24,16,40,0.6,0.512820512820513
99,"Bristleback",110,"Phoenix",31,30,61,0.508196721311475,0.782051282051282
99,"Bristleback",111,"Oracle",12,21,33,0.363636363636364,0.423076923076923
99,"Bristleback",112,"Winter Wyvern",132,121,253,0.521739130434783,3.24358974358974
100,"Tusk",101,"Skywrath Mage",112,118,230,0.48695652173913,2.94871794871795
100,"Tusk",102,"Abaddon",128,67,195,0.656410256410256,2.5
100,"Tusk",103,"Elder Titan",18,21,39,0.461538461538462,0.5
100,"Tusk",104,"Legion Commander",264,273,537,0.491620111731844,6.88461538461539
100,"Tusk",105,"Techies",38,55,93,0.408602150537634,1.19230769230769
100,"Tusk",106,"Ember Spirit",353,350,703,0.502133712660028,9.01282051282051
100,"Tusk",107,"Earth Spirit",83,79,162,0.512345679012346,2.07692307692308
100,"Tusk",109,"Terrorblade",67,50,117,0.572649572649573,1.5
100,"Tusk",110,"Phoenix",98,86,184,0.532608695652174,2.35897435897436
100,"Tusk",111,"Oracle",30,33,63,0.476190476190476,0.807692307692308
100,"Tusk",112,"Winter Wyvern",295,284,579,0.509499136442142,7.42307692307692
101,"Skywrath Mage",102,"Abaddon",22,26,48,0.458333333333333,0.615384615384615
101,"Skywrath Mage",103,"Elder Titan",8,4,12,0.666666666666667,0.153846153846154
101,"Skywrath Mage",104,"Legion Commander",103,161,264,0.390151515151515,3.38461538461538
101,"Skywrath Mage",105,"Techies",10,12,22,0.454545454545455,0.282051282051282
101,"Skywrath Mage",106,"Ember Spirit",64,124,188,0.340425531914894,2.41025641025641
101,"Skywrath Mage",107,"Earth Spirit",34,37,71,0.47887323943662,0.91025641025641
101,"Skywrath Mage",109,"Terrorblade",13,18,31,0.419354838709677,0.397435897435897
101,"Skywrath Mage",110,"Phoenix",30,28,58,0.517241379310345,0.743589743589744
101,"Skywrath Mage",111,"Oracle",5,12,17,0.294117647058824,0.217948717948718
101,"Skywrath Mage",112,"Winter Wyvern",42,47,89,0.471910112359551,1.14102564102564
102,"Abaddon",103,"Elder Titan",7,3,10,0.7,0.128205128205128
102,"Abaddon",104,"Legion Commander",102,86,188,0.542553191489362,2.41025641025641
102,"Abaddon",105,"Techies",18,7,25,0.72,0.320512820512821
102,"Abaddon",106,"Ember Spirit",92,85,177,0.519774011299435,2.26923076923077
102,"Abaddon",107,"Earth Spirit",19,30,49,0.387755102040816,0.628205128205128
102,"Abaddon",109,"Terrorblade",25,19,44,0.568181818181818,0.564102564102564
102,"Abaddon",110,"Phoenix",41,29,70,0.585714285714286,0.897435897435897
102,"Abaddon",111,"Oracle",11,11,22,0.5,0.282051282051282
102,"Abaddon",112,"Winter Wyvern",82,59,141,0.581560283687943,1.80769230769231
103,"Elder Titan",104,"Legion Commander",32,28,60,0.533333333333333,0.769230769230769
103,"Elder Titan",105,"Techies",3,0,3,1,0.0384615384615385
103,"Elder Titan",106,"Ember Spirit",32,31,63,0.507936507936508,0.807692307692308
103,"Elder Titan",107,"Earth Spirit",5,3,8,0.625,0.102564102564103
103,"Elder Titan",109,"Terrorblade",7,4,11,0.636363636363636,0.141025641025641
103,"Elder Titan",110,"Phoenix",3,8,11,0.272727272727273,0.141025641025641
103,"Elder Titan",111,"Oracle",3,0,3,1,0.0384615384615385
103,"Elder Titan",112,"Winter Wyvern",29,11,40,0.725,0.512820512820513
104,"Legion Commander",105,"Techies",38,51,89,0.426966292134831,1.14102564102564
104,"Legion Commander",106,"Ember Spirit",191,230,421,0.453681710213777,5.3974358974359
104,"Legion Commander",107,"Earth Spirit",68,77,145,0.468965517241379,1.85897435897436
104,"Legion Commander",109,"Terrorblade",41,41,82,0.5,1.05128205128205
104,"Legion Commander",110,"Phoenix",111,89,200,0.555,2.56410256410256
104,"Legion Commander",111,"Oracle",39,38,77,0.506493506493506,0.987179487179487
104,"Legion Commander",112,"Winter Wyvern",232,226,458,0.506550218340611,5.87179487179487
105,"Techies",106,"Ember Spirit",31,33,64,0.484375,0.82051282051282
105,"Techies",107,"Earth Spirit",6,6,12,0.5,0.153846153846154
105,"Techies",109,"Terrorblade",6,4,10,0.6,0.128205128205128
105,"Techies",110,"Phoenix",12,11,23,0.521739130434783,0.294871794871795
105,"Techies",111,"Oracle",3,6,9,0.333333333333333,0.115384615384615
105,"Techies",112,"Winter Wyvern",15,31,46,0.326086956521739,0.58974358974359
106,"Ember Spirit",107,"Earth Spirit",92,104,196,0.469387755102041,2.51282051282051
106,"Ember Spirit",109,"Terrorblade",41,28,69,0.594202898550725,0.884615384615385
106,"Ember Spirit",110,"Phoenix",88,96,184,0.478260869565217,2.35897435897436
106,"Ember Spirit",111,"Oracle",35,35,70,0.5,0.897435897435897
106,"Ember Spirit",112,"Winter Wyvern",237,264,501,0.473053892215569,6.42307692307692
107,"Earth Spirit",109,"Terrorblade",21,15,36,0.583333333333333,0.461538461538462
107,"Earth Spirit",110,"Phoenix",19,23,42,0.452380952380952,0.538461538461538
107,"Earth Spirit",111,"Oracle",16,8,24,0.666666666666667,0.307692307692308
107,"Earth Spirit",112,"Winter Wyvern",92,78,170,0.541176470588235,2.17948717948718
109,"Terrorblade",110,"Phoenix",10,15,25,0.4,0.320512820512821
109,"Terrorblade",111,"Oracle",10,10,20,0.5,0.256410256410256
109,"Terrorblade",112,"Winter Wyvern",42,32,74,0.567567567567568,0.948717948717949
110,"Phoenix",111,"Oracle",12,16,28,0.428571428571429,0.358974358974359
110,"Phoenix",112,"Winter Wyvern",121,116,237,0.510548523206751,3.03846153846154
111,"Oracle",112,"Winter Wyvern",17,16,33,0.515151515151515,0.423076923076923
